"Model","stimulus","MOS","VP1","VP2","VP3","VP4","TotalPatches"
"PRI_Hepatus","PRI_Hepatus_simpL1_qp11_qt9_decompJPEG_712x712_Q10",0.337209302325583,57,40,52,40,189
"lizard_BakedUV","lizard_BakedUV_simpL9_qp11_qt7_decompJPEG_712x712_Q75",0.363095238095237,13,2,1,6,22
"shark_bakedUV","shark_bakedUV_simpL10_qp9_qt6_decompJPEG_1440x1440_Q90",0.80625,22,21,15,28,86
"Orchid","Orchid_simpL4_qp10_qt9_decompJPEG_512x512_Q75",0.0388888888888901,70,72,43,82,267
"Flintlock_Pistol","Flintlock_Pistol_simpL5_qp7_qt9_decompJPEG_2048x2048_Q10",0.982142857142857,9,5,10,8,32
"PlaningMachine200K","PlaningMachine200K_simpL9_qp8_qt6_decompJPEG_1440x1440_Q10",0.575581395348837,60,62,67,58,247
"Orchid","Orchid_simpL3_qp8_qt10_decompJPEG_1024x1024_Q50",0.15340909090909,70,72,43,82,267
"bread_BakedUV","bread_BakedUV_simpL7_qp9_qt7_decompJPEG_1024x1024_Q50",0.622222222222222,74,52,30,54,210
"shark_bakedUV","shark_bakedUV_simpL10_qp8_qt6_decompJPEG_1440x1440_Q10",0.825581395348838,22,21,15,28,86
"dino_retopo_uv","dino_retopo_uv_simpL7_qp11_qt8_decompJPEG_1440x1440_Q10",0.2125,23,49,25,7,104
"dorfkirche","dorfkirche_simpL7_qp10_qt10_decompJPEG_1024x1024_Q10",0.238636363636362,70,61,73,54,258
"shark_bakedUV","shark_bakedUV_simpL4_qp10_qt9_decompJPEG_712x712_Q75",0.405555555555555,22,21,15,28,86
"dino_retopo_uv","dino_retopo_uv_simpL1_qp11_qt7_decompJPEG_512x512_Q90",0.446428571428573,23,49,25,7,104
"Orchid","Orchid_simpL1_qp11_qt7_decompJPEG_1440x1440_Q50",0.0952380952380949,70,72,43,82,267
"dorfkirche","dorfkirche_simpL6_qp11_qt10_decompJPEG_512x512_Q50",0.115853658536585,70,61,73,54,258
"Lidded-Ewer_bakedUV","Lidded-Ewer_bakedUV_simpL4_qp10_qt8_decompJPEG_2048x2048_Q75",0.220238095238095,61,56,66,54,237
"PlaningMachine200K","PlaningMachine200K_simpL9_qp8_qt6_decompJPEG_712x712_Q50",0.59375,60,62,67,58,247
"dino_retopo_uv","dino_retopo_uv_simpL2_qp11_qt8_decompJPEG_2048x2048_Q90",0.36904761904762,23,49,25,7,104
"dorfkirche","dorfkirche_simpL2_qp10_qt10_decompJPEG_712x712_Q25",0.174418604651162,70,61,73,54,258
"dino_retopo_uv","dino_retopo_uv_simpL7_qp9_qt10_decompJPEG_512x512_Q25",0.25,23,49,25,7,104
"dino_retopo_uv","dino_retopo_uv_simpL2_qp11_qt6_decompJPEG_1024x1024_Q25",0.786585365853657,23,49,25,7,104
"PRI_Hepatus","PRI_Hepatus_simpL8_qp11_qt7_decompJPEG_1440x1440_Q25",0.494186046511627,57,40,52,40,189
"PlaningMachine200K","PlaningMachine200K_simpL8_qp11_qt10_decompJPEG_512x512_Q50",0.202380952380953,60,62,67,58,247
"shark_bakedUV","shark_bakedUV_simpL10_qp9_qt6_decompJPEG_2048x2048_Q10",0.80813953488372,22,21,15,28,86
"PlaningMachine200K","PlaningMachine200K_simpL9_qp8_qt6_decompJPEG_2048x2048_Q90",0.622222222222222,60,62,67,58,247
"PRI_Hepatus","PRI_Hepatus_simpL8_qp11_qt8_decompJPEG_712x712_Q10",0.335365853658538,57,40,52,40,189
"Triceratops_manifold","Triceratops_manifold_simpL1_qp9_qt9_decompJPEG_1024x1024_Q10",0.236842105263158,22,17,22,26,87
"shark_bakedUV","shark_bakedUV_simpL10_qp9_qt10_decompJPEG_2048x2048_Q50",0.583333333333332,22,21,15,28,86
"PRI_Hepatus","PRI_Hepatus_simpL1_qp8_qt10_decompJPEG_2048x2048_Q50",0.63095238095238,57,40,52,40,189
"shark_bakedUV","shark_bakedUV_simpL10_qp9_qt6_decompJPEG_1024x1024_Q90",0.75,22,21,15,28,86
"PRI_Hepatus","PRI_Hepatus_simpL8_qp7_qt6_decompJPEG_1024x1024_Q10",0.9375,57,40,52,40,189
"lizard_BakedUV","lizard_BakedUV_simpL10_qp7_qt9_decompJPEG_712x712_Q10",0.767441860465117,13,2,1,6,22
"bread_BakedUV","bread_BakedUV_simpL3_qp9_qt9_decompJPEG_512x512_Q75",0.301282051282053,74,52,30,54,210
"PRI_Hepatus","PRI_Hepatus_simpL3_qp11_qt8_decompJPEG_512x512_Q75",0.298780487804878,57,40,52,40,189
"lizard_BakedUV","lizard_BakedUV_simpL10_qp7_qt7_decompJPEG_712x712_Q10",0.762820512820513,13,2,1,6,22
"Lidded-Ewer_bakedUV","Lidded-Ewer_bakedUV_simpL4_qp11_qt8_decompJPEG_512x512_Q50",0.15340909090909,61,56,66,54,237
"PRI_Hepatus","PRI_Hepatus_simpL4_qp9_qt6_decompJPEG_712x712_Q25",0.79375,57,40,52,40,189
"PRI_Hepatus","PRI_Hepatus_simpL5_qp11_qt8_decompJPEG_512x512_Q10",0.4875,57,40,52,40,189
"PlaningMachine200K","PlaningMachine200K_simpL9_qp8_qt7_decompJPEG_512x512_Q25",0.541666666666668,60,62,67,58,247
"Triceratops_manifold","Triceratops_manifold_simpL9_qp7_qt10_decompJPEG_512x512_Q25",0.726190476190475,22,17,22,26,87
"Orchid","Orchid_simpL4_qp11_qt7_decompJPEG_712x712_Q25",0.174418604651162,70,72,43,82,267
"PRI_Hepatus","PRI_Hepatus_simpL7_qp9_qt7_decompJPEG_1440x1440_Q10",0.676136363636363,57,40,52,40,189
"Lidded-Ewer_bakedUV","Lidded-Ewer_bakedUV_simpL5_qp10_qt9_decompJPEG_2048x2048_Q90",0.178571428571427,61,56,66,54,237
"Flintlock_Pistol","Flintlock_Pistol_simpL6_qp7_qt6_decompJPEG_712x712_Q25",0.94047619047619,9,5,10,8,32
"Flintlock_Pistol","Flintlock_Pistol_simpL1_qp9_qt7_decompJPEG_1440x1440_Q90",0.647727272727272,9,5,10,8,32
"dino_retopo_uv","dino_retopo_uv_simpL4_qp9_qt8_decompJPEG_1440x1440_Q75",0.428571428571427,23,49,25,7,104
"Triceratops_manifold","Triceratops_manifold_simpL9_qp7_qt9_decompJPEG_512x512_Q50",0.714285714285715,22,17,22,26,87
"PRI_Hepatus","PRI_Hepatus_simpL4_qp11_qt9_decompJPEG_512x512_Q10",0.426829268292683,57,40,52,40,189
"Orchid","Orchid_simpL9_qp8_qt7_decompJPEG_712x712_Q25",0.255813953488373,70,72,43,82,267
"Lidded-Ewer_bakedUV","Lidded-Ewer_bakedUV_simpL7_qp10_qt7_decompJPEG_512x512_Q50",0.355555555555555,61,56,66,54,237
"shark_bakedUV","shark_bakedUV_simpL10_qp9_qt10_decompJPEG_1440x1440_Q50",0.634146341463415,22,21,15,28,86
"Flintlock_Pistol","Flintlock_Pistol_simpL5_qp7_qt6_decompJPEG_1440x1440_Q10",0.98076923076923,9,5,10,8,32
"Flintlock_Pistol","Flintlock_Pistol_simpL10_qp11_qt6_decompJPEG_1024x1024_Q50",0.726744186046512,9,5,10,8,32
"Flintlock_Pistol","Flintlock_Pistol_simpL6_qp7_qt10_decompJPEG_2048x2048_Q10",0.982558139534883,9,5,10,8,32
"Triceratops_manifold","Triceratops_manifold_simpL9_qp7_qt9_decompJPEG_1024x1024_Q50",0.634615384615385,22,17,22,26,87
"shark_bakedUV","shark_bakedUV_simpL10_qp9_qt10_decompJPEG_1440x1440_Q25",0.63095238095238,22,21,15,28,86
"Triceratops_manifold","Triceratops_manifold_simpL1_qp8_qt7_decompJPEG_1440x1440_Q10",0.648809523809525,22,17,22,26,87
"shark_bakedUV","shark_bakedUV_simpL9_qp10_qt8_decompJPEG_1024x1024_Q50",0.348837209302325,22,21,15,28,86
"dorfkirche","dorfkirche_simpL1_qp10_qt10_decompJPEG_512x512_Q10",0.448863636363637,70,61,73,54,258
"dorfkirche","dorfkirche_simpL9_qp11_qt9_decompJPEG_512x512_Q90",0.196428571428573,70,61,73,54,258
"PlaningMachine200K","PlaningMachine200K_simpL8_qp9_qt9_decompJPEG_512x512_Q50",0.267045454545455,60,62,67,58,247
"dino_retopo_uv","dino_retopo_uv_simpL8_qp9_qt10_decompJPEG_1024x1024_Q25",0.25609756097561,23,49,25,7,104
"lizard_BakedUV","lizard_BakedUV_simpL6_qp10_qt6_decompJPEG_1024x1024_Q10",0.5125,13,2,1,6,22
"PlaningMachine200K","PlaningMachine200K_simpL10_qp7_qt7_decompJPEG_1024x1024_Q75",0.994318181818183,60,62,67,58,247
"PlaningMachine200K","PlaningMachine200K_simpL9_qp7_qt7_decompJPEG_512x512_Q25",0.715116279069767,60,62,67,58,247
"Triceratops_manifold","Triceratops_manifold_simpL1_qp9_qt6_decompJPEG_712x712_Q25",0.464285714285715,22,17,22,26,87
"Orchid","Orchid_simpL9_qp8_qt7_decompJPEG_1440x1440_Q10",0.26111111111111,70,72,43,82,267
"Orchid","Orchid_simpL3_qp10_qt7_decompJPEG_2048x2048_Q25",0.0833333333333326,70,72,43,82,267
"Lidded-Ewer_bakedUV","Lidded-Ewer_bakedUV_simpL7_qp10_qt10_decompJPEG_2048x2048_Q10",0.329545454545455,61,56,66,54,237
"dorfkirche","dorfkirche_simpL9_qp11_qt9_decompJPEG_512x512_Q75",0.1875,70,61,73,54,258
"Triceratops_manifold","Triceratops_manifold_simpL8_qp11_qt6_decompJPEG_1440x1440_Q90",0.34090909090909,22,17,22,26,87
"dino_retopo_uv","dino_retopo_uv_simpL5_qp10_qt8_decompJPEG_512x512_Q75",0.122093023255815,23,49,25,7,104
"PlaningMachine200K","PlaningMachine200K_simpL9_qp8_qt6_decompJPEG_512x512_Q90",0.64375,60,62,67,58,247
"Flintlock_Pistol","Flintlock_Pistol_simpL10_qp7_qt6_decompJPEG_712x712_Q25",0.916666666666668,9,5,10,8,32
"dorfkirche","dorfkirche_simpL5_qp9_qt6_decompJPEG_512x512_Q10",0.806818181818183,70,61,73,54,258
"bread_BakedUV","bread_BakedUV_simpL7_qp7_qt7_decompJPEG_2048x2048_Q90",0.656976744186047,74,52,30,54,210
"lizard_BakedUV","lizard_BakedUV_simpL1_qp7_qt6_decompJPEG_2048x2048_Q25",0.976190476190475,13,2,1,6,22
"lizard_BakedUV","lizard_BakedUV_simpL10_qp7_qt8_decompJPEG_1440x1440_Q25",0.732558139534882,13,2,1,6,22
"Flintlock_Pistol","Flintlock_Pistol_simpL2_qp9_qt6_decompJPEG_2048x2048_Q75",0.61904761904762,9,5,10,8,32
"shark_bakedUV","shark_bakedUV_simpL10_qp9_qt10_decompJPEG_1440x1440_Q75",0.601190476190475,22,21,15,28,86
"shark_bakedUV","shark_bakedUV_simpL1_qp11_qt9_decompJPEG_512x512_Q90",0.323863636363637,22,21,15,28,86
"shark_bakedUV","shark_bakedUV_simpL9_qp10_qt6_decompJPEG_1024x1024_Q25",0.810975609756098,22,21,15,28,86
"shark_bakedUV","shark_bakedUV_simpL10_qp9_qt6_decompJPEG_1440x1440_Q75",0.796511627906977,22,21,15,28,86
"Flintlock_Pistol","Flintlock_Pistol_simpL9_qp8_qt6_decompJPEG_2048x2048_Q25",0.837209302325582,9,5,10,8,32
"dino_retopo_uv","dino_retopo_uv_simpL9_qp8_qt10_decompJPEG_1440x1440_Q50",0.63953488372093,23,49,25,7,104
"Triceratops_manifold","Triceratops_manifold_simpL9_qp7_qt9_decompJPEG_512x512_Q75",0.593023255813953,22,17,22,26,87
"dino_retopo_uv","dino_retopo_uv_simpL5_qp11_qt6_decompJPEG_712x712_Q50",0.767857142857143,23,49,25,7,104
"dino_retopo_uv","dino_retopo_uv_simpL5_qp9_qt8_decompJPEG_1024x1024_Q75",0.30232558139535,23,49,25,7,104
"shark_bakedUV","shark_bakedUV_simpL10_qp7_qt6_decompJPEG_1440x1440_Q50",0.925,22,21,15,28,86
"PlaningMachine200K","PlaningMachine200K_simpL1_qp10_qt10_decompJPEG_1024x1024_Q75",0.164772727272728,60,62,67,58,247
"dino_retopo_uv","dino_retopo_uv_simpL8_qp10_qt6_decompJPEG_1024x1024_Q25",0.675,23,49,25,7,104
"PRI_Hepatus","PRI_Hepatus_simpL8_qp8_qt10_decompJPEG_1440x1440_Q50",0.52840909090909,57,40,52,40,189
"Orchid","Orchid_simpL6_qp8_qt6_decompJPEG_1440x1440_Q25",0.430232558139535,70,72,43,82,267
"Flintlock_Pistol","Flintlock_Pistol_simpL2_qp8_qt6_decompJPEG_712x712_Q90",0.94047619047619,9,5,10,8,32
"Lidded-Ewer_bakedUV","Lidded-Ewer_bakedUV_simpL6_qp11_qt7_decompJPEG_512x512_Q50",0.343023255813953,61,56,66,54,237
"lizard_BakedUV","lizard_BakedUV_simpL9_qp10_qt7_decompJPEG_2048x2048_Q75",0.30813953488372,13,2,1,6,22
"Orchid","Orchid_simpL9_qp11_qt9_decompJPEG_1024x1024_Q90",0.214285714285715,70,72,43,82,267
"Orchid","Orchid_simpL2_qp10_qt7_decompJPEG_512x512_Q75",0.119318181818183,70,72,43,82,267
"Flintlock_Pistol","Flintlock_Pistol_simpL3_qp8_qt6_decompJPEG_1440x1440_Q50",0.883720930232557,9,5,10,8,32
"dino_retopo_uv","dino_retopo_uv_simpL5_qp9_qt8_decompJPEG_2048x2048_Q50",0.377906976744185,23,49,25,7,104
"bread_BakedUV","bread_BakedUV_simpL5_qp8_qt10_decompJPEG_712x712_Q25",0.401162790697675,74,52,30,54,210
"Orchid","Orchid_simpL8_qp8_qt7_decompJPEG_2048x2048_Q90",0.24404761904762,70,72,43,82,267
"bread_BakedUV","bread_BakedUV_simpL7_qp10_qt7_decompJPEG_2048x2048_Q50",0.472222222222223,74,52,30,54,210
"shark_bakedUV","shark_bakedUV_simpL10_qp9_qt6_decompJPEG_1440x1440_Q50",0.817073170731707,22,21,15,28,86
"dino_retopo_uv","dino_retopo_uv_simpL1_qp10_qt6_decompJPEG_712x712_Q10",0.727272727272728,23,49,25,7,104
"Triceratops_manifold","Triceratops_manifold_simpL4_qp8_qt6_decompJPEG_2048x2048_Q10",0.633333333333333,22,17,22,26,87
"dino_retopo_uv","dino_retopo_uv_simpL10_qp11_qt9_decompJPEG_1024x1024_Q90",0.829545454545455,23,49,25,7,104
"Triceratops_manifold","Triceratops_manifold_simpL6_qp8_qt9_decompJPEG_512x512_Q50",0.49404761904762,22,17,22,26,87
"Triceratops_manifold","Triceratops_manifold_simpL4_qp10_qt7_decompJPEG_2048x2048_Q10",0.13095238095238,22,17,22,26,87
"Orchid","Orchid_simpL1_qp9_qt6_decompJPEG_512x512_Q10",0.535714285714285,70,72,43,82,267
"Lidded-Ewer_bakedUV","Lidded-Ewer_bakedUV_simpL7_qp10_qt8_decompJPEG_512x512_Q25",0.392045454545455,61,56,66,54,237
"Triceratops_manifold","Triceratops_manifold_simpL2_qp8_qt10_decompJPEG_712x712_Q10",0.633720930232557,22,17,22,26,87
"Lidded-Ewer_bakedUV","Lidded-Ewer_bakedUV_simpL1_qp10_qt8_decompJPEG_712x712_Q10",0.269736842105262,61,56,66,54,237
"Orchid","Orchid_simpL8_qp10_qt8_decompJPEG_1024x1024_Q10",0.205555555555555,70,72,43,82,267
"PRI_Hepatus","PRI_Hepatus_simpL7_qp10_qt8_decompJPEG_712x712_Q25",0.327380952380953,57,40,52,40,189
"dino_retopo_uv","dino_retopo_uv_simpL3_qp11_qt6_decompJPEG_712x712_Q50",0.784883720930233,23,49,25,7,104
"lizard_BakedUV","lizard_BakedUV_simpL10_qp7_qt10_decompJPEG_1440x1440_Q50",0.786585365853657,13,2,1,6,22
"Orchid","Orchid_simpL9_qp11_qt7_decompJPEG_1440x1440_Q10",0.261363636363637,70,72,43,82,267
"Flintlock_Pistol","Flintlock_Pistol_simpL4_qp7_qt6_decompJPEG_1440x1440_Q10",0.958333333333332,9,5,10,8,32
"PRI_Hepatus","PRI_Hepatus_simpL3_qp10_qt8_decompJPEG_1440x1440_Q75",0.329268292682927,57,40,52,40,189
"shark_bakedUV","shark_bakedUV_simpL10_qp9_qt10_decompJPEG_2048x2048_Q75",0.613636363636363,22,21,15,28,86
"dorfkirche","dorfkirche_simpL5_qp9_qt10_decompJPEG_512x512_Q50",0.333333333333332,70,61,73,54,258
"dino_retopo_uv","dino_retopo_uv_simpL6_qp10_qt6_decompJPEG_712x712_Q50",0.683333333333332,23,49,25,7,104
"bread_BakedUV","bread_BakedUV_simpL7_qp10_qt9_decompJPEG_712x712_Q50",0.49404761904762,74,52,30,54,210
"dino_retopo_uv","dino_retopo_uv_simpL6_qp9_qt8_decompJPEG_512x512_Q50",0.301136363636363,23,49,25,7,104
"PlaningMachine200K","PlaningMachine200K_simpL1_qp11_qt7_decompJPEG_1024x1024_Q10",0.19375,60,62,67,58,247
"dorfkirche","dorfkirche_simpL7_qp9_qt10_decompJPEG_1440x1440_Q75",0.3125,70,61,73,54,258
"dorfkirche","dorfkirche_simpL8_qp11_qt8_decompJPEG_512x512_Q50",0.30232558139535,70,61,73,54,258
"bread_BakedUV","bread_BakedUV_simpL3_qp10_qt10_decompJPEG_712x712_Q25",0.27439024390244,74,52,30,54,210
"shark_bakedUV","shark_bakedUV_simpL10_qp7_qt6_decompJPEG_1024x1024_Q25",0.947368421052633,22,21,15,28,86
"Flintlock_Pistol","Flintlock_Pistol_simpL7_qp8_qt7_decompJPEG_512x512_Q50",0.829545454545455,9,5,10,8,32
"PlaningMachine200K","PlaningMachine200K_simpL9_qp8_qt6_decompJPEG_1024x1024_Q75",0.65340909090909,60,62,67,58,247
"PRI_Hepatus","PRI_Hepatus_simpL8_qp11_qt7_decompJPEG_1024x1024_Q50",0.505555555555555,57,40,52,40,189
"dino_retopo_uv","dino_retopo_uv_simpL5_qp10_qt9_decompJPEG_2048x2048_Q10",0.176136363636362,23,49,25,7,104
"dorfkirche","dorfkirche_simpL9_qp11_qt8_decompJPEG_1024x1024_Q10",0.406976744186047,70,61,73,54,258
"shark_bakedUV","shark_bakedUV_simpL9_qp11_qt6_decompJPEG_1024x1024_Q75",0.744186046511627,22,21,15,28,86
"PRI_Hepatus","PRI_Hepatus_simpL5_qp7_qt6_decompJPEG_2048x2048_Q10",0.94767441860465,57,40,52,40,189
"lizard_BakedUV","lizard_BakedUV_simpL5_qp10_qt6_decompJPEG_712x712_Q10",0.427631578947367,13,2,1,6,22
"PRI_Hepatus","PRI_Hepatus_simpL2_qp10_qt9_decompJPEG_512x512_Q10",0.396341463414635,57,40,52,40,189
"dino_retopo_uv","dino_retopo_uv_simpL4_qp11_qt6_decompJPEG_1440x1440_Q50",0.835227272727272,23,49,25,7,104
"Flintlock_Pistol","Flintlock_Pistol_simpL4_qp7_qt6_decompJPEG_712x712_Q10",0.976744186046512,9,5,10,8,32
"Triceratops_manifold","Triceratops_manifold_simpL9_qp9_qt6_decompJPEG_1024x1024_Q25",0.352272727272728,22,17,22,26,87
"dino_retopo_uv","dino_retopo_uv_simpL8_qp9_qt6_decompJPEG_2048x2048_Q75",0.801136363636362,23,49,25,7,104
"bread_BakedUV","bread_BakedUV_simpL5_qp9_qt8_decompJPEG_512x512_Q75",0.431818181818183,74,52,30,54,210
"Orchid","Orchid_simpL9_qp8_qt9_decompJPEG_2048x2048_Q10",0.21590909090909,70,72,43,82,267
"lizard_BakedUV","lizard_BakedUV_simpL9_qp9_qt6_decompJPEG_712x712_Q75",0.5,13,2,1,6,22
"Triceratops_manifold","Triceratops_manifold_simpL1_qp8_qt6_decompJPEG_2048x2048_Q10",0.715116279069767,22,17,22,26,87
"PRI_Hepatus","PRI_Hepatus_simpL5_qp7_qt10_decompJPEG_2048x2048_Q10",0.920454545454545,57,40,52,40,189
"Triceratops_manifold","Triceratops_manifold_simpL9_qp7_qt9_decompJPEG_2048x2048_Q75",0.681818181818183,22,17,22,26,87
"lizard_BakedUV","lizard_BakedUV_simpL8_qp10_qt8_decompJPEG_512x512_Q90",0.25,13,2,1,6,22
"dorfkirche","dorfkirche_simpL5_qp10_qt8_decompJPEG_2048x2048_Q90",0.345238095238095,70,61,73,54,258
"dorfkirche","dorfkirche_simpL9_qp11_qt10_decompJPEG_512x512_Q50",0.214285714285715,70,61,73,54,258
"shark_bakedUV","shark_bakedUV_simpL6_qp11_qt6_decompJPEG_1024x1024_Q10",0.81875,22,21,15,28,86
"Lidded-Ewer_bakedUV","Lidded-Ewer_bakedUV_simpL8_qp10_qt8_decompJPEG_2048x2048_Q10",0.50595238095238,61,56,66,54,237
"lizard_BakedUV","lizard_BakedUV_simpL5_qp10_qt6_decompJPEG_712x712_Q50",0.422619047619047,13,2,1,6,22
"PRI_Hepatus","PRI_Hepatus_simpL1_qp7_qt6_decompJPEG_512x512_Q10",0.943181818181817,57,40,52,40,189
"PRI_Hepatus","PRI_Hepatus_simpL8_qp9_qt6_decompJPEG_1440x1440_Q10",0.833333333333332,57,40,52,40,189
"lizard_BakedUV","lizard_BakedUV_simpL10_qp7_qt6_decompJPEG_512x512_Q50",0.761363636363638,13,2,1,6,22
"Triceratops_manifold","Triceratops_manifold_simpL7_qp9_qt6_decompJPEG_512x512_Q50",0.392857142857142,22,17,22,26,87
"dino_retopo_uv","dino_retopo_uv_simpL6_qp9_qt8_decompJPEG_712x712_Q90",0.38095238095238,23,49,25,7,104
"shark_bakedUV","shark_bakedUV_simpL4_qp10_qt9_decompJPEG_712x712_Q50",0.427777777777777,22,21,15,28,86
"PRI_Hepatus","PRI_Hepatus_simpL3_qp11_qt7_decompJPEG_512x512_Q10",0.75,57,40,52,40,189
"dino_retopo_uv","dino_retopo_uv_simpL6_qp11_qt6_decompJPEG_512x512_Q25",0.680232558139535,23,49,25,7,104
"Flintlock_Pistol","Flintlock_Pistol_simpL10_qp7_qt6_decompJPEG_512x512_Q10",0.906976744186047,9,5,10,8,32
"PlaningMachine200K","PlaningMachine200K_simpL9_qp8_qt7_decompJPEG_1440x1440_Q10",0.567073170731707,60,62,67,58,247
"shark_bakedUV","shark_bakedUV_simpL1_qp11_qt10_decompJPEG_512x512_Q90",0.273809523809525,22,21,15,28,86
"lizard_BakedUV","lizard_BakedUV_simpL7_qp11_qt8_decompJPEG_712x712_Q50",0.154761904761905,13,2,1,6,22
"dino_retopo_uv","dino_retopo_uv_simpL7_qp10_qt6_decompJPEG_1440x1440_Q50",0.755681818181817,23,49,25,7,104
"bread_BakedUV","bread_BakedUV_simpL10_qp7_qt8_decompJPEG_2048x2048_Q25",0.744318181818183,74,52,30,54,210
"bread_BakedUV","bread_BakedUV_simpL2_qp7_qt7_decompJPEG_2048x2048_Q50",0.63095238095238,74,52,30,54,210
"Orchid","Orchid_simpL9_qp8_qt7_decompJPEG_1024x1024_Q75",0.22093023255814,70,72,43,82,267
"dino_retopo_uv","dino_retopo_uv_simpL1_qp9_qt9_decompJPEG_1440x1440_Q25",0.125,23,49,25,7,104
"dorfkirche","dorfkirche_simpL1_qp10_qt8_decompJPEG_1024x1024_Q50",0.267441860465118,70,61,73,54,258
"Lidded-Ewer_bakedUV","Lidded-Ewer_bakedUV_simpL1_qp10_qt8_decompJPEG_1440x1440_Q75",0.127906976744185,61,56,66,54,237
"Lidded-Ewer_bakedUV","Lidded-Ewer_bakedUV_simpL5_qp11_qt8_decompJPEG_512x512_Q10",0.394444444444445,61,56,66,54,237
"Triceratops_manifold","Triceratops_manifold_simpL1_qp11_qt6_decompJPEG_512x512_Q75",0.294871794871795,22,17,22,26,87
"bread_BakedUV","bread_BakedUV_simpL8_qp9_qt10_decompJPEG_1440x1440_Q75",0.50625,74,52,30,54,210
"bread_BakedUV","bread_BakedUV_simpL4_qp9_qt8_decompJPEG_1024x1024_Q10",0.420454545454545,74,52,30,54,210
"dino_retopo_uv","dino_retopo_uv_simpL4_qp10_qt8_decompJPEG_512x512_Q90",0.198863636363638,23,49,25,7,104
"Flintlock_Pistol","Flintlock_Pistol_simpL5_qp7_qt9_decompJPEG_712x712_Q50",0.982558139534883,9,5,10,8,32
"dino_retopo_uv","dino_retopo_uv_simpL4_qp11_qt6_decompJPEG_712x712_Q50",0.755681818181817,23,49,25,7,104
"shark_bakedUV","shark_bakedUV_simpL10_qp11_qt6_decompJPEG_1024x1024_Q90",0.73780487804878,22,21,15,28,86
"dorfkirche","dorfkirche_simpL2_qp11_qt7_decompJPEG_1024x1024_Q50",0.65340909090909,70,61,73,54,258
"Lidded-Ewer_bakedUV","Lidded-Ewer_bakedUV_simpL8_qp9_qt8_decompJPEG_2048x2048_Q50",0.4875,61,56,66,54,237
"bread_BakedUV","bread_BakedUV_simpL8_qp7_qt10_decompJPEG_712x712_Q10",0.767857142857143,74,52,30,54,210
"Flintlock_Pistol","Flintlock_Pistol_simpL4_qp8_qt10_decompJPEG_1024x1024_Q90",0.848837209302325,9,5,10,8,32
"PlaningMachine200K","PlaningMachine200K_simpL9_qp8_qt7_decompJPEG_512x512_Q10",0.573863636363637,60,62,67,58,247
"Triceratops_manifold","Triceratops_manifold_simpL9_qp7_qt10_decompJPEG_2048x2048_Q25",0.63095238095238,22,17,22,26,87
"dino_retopo_uv","dino_retopo_uv_simpL5_qp9_qt9_decompJPEG_2048x2048_Q10",0.383720930232557,23,49,25,7,104
"PlaningMachine200K","PlaningMachine200K_simpL10_qp7_qt6_decompJPEG_712x712_Q90",0.97093023255814,60,62,67,58,247
"PRI_Hepatus","PRI_Hepatus_simpL3_qp8_qt9_decompJPEG_712x712_Q10",0.708333333333332,57,40,52,40,189
"dorfkirche","dorfkirche_simpL8_qp10_qt8_decompJPEG_2048x2048_Q10",0.351190476190475,70,61,73,54,258
"shark_bakedUV","shark_bakedUV_simpL10_qp9_qt6_decompJPEG_1024x1024_Q75",0.8,22,21,15,28,86
"PRI_Hepatus","PRI_Hepatus_simpL9_qp9_qt8_decompJPEG_512x512_Q10",0.5,57,40,52,40,189
"dorfkirche","dorfkirche_simpL4_qp9_qt9_decompJPEG_2048x2048_Q75",0.267441860465118,70,61,73,54,258
"Flintlock_Pistol","Flintlock_Pistol_simpL9_qp8_qt6_decompJPEG_1440x1440_Q25",0.829545454545455,9,5,10,8,32
"Flintlock_Pistol","Flintlock_Pistol_simpL5_qp7_qt9_decompJPEG_1024x1024_Q50",0.98125,9,5,10,8,32
"bread_BakedUV","bread_BakedUV_simpL6_qp11_qt6_decompJPEG_2048x2048_Q90",0.789772727272728,74,52,30,54,210
"PRI_Hepatus","PRI_Hepatus_simpL5_qp11_qt8_decompJPEG_512x512_Q50",0.28409090909091,57,40,52,40,189
"bread_BakedUV","bread_BakedUV_simpL8_qp9_qt9_decompJPEG_712x712_Q25",0.585227272727272,74,52,30,54,210
"Orchid","Orchid_simpL3_qp9_qt8_decompJPEG_2048x2048_Q90",0.09375,70,72,43,82,267
"lizard_BakedUV","lizard_BakedUV_simpL7_qp8_qt10_decompJPEG_1440x1440_Q90",0.5625,13,2,1,6,22
"dorfkirche","dorfkirche_simpL4_qp10_qt7_decompJPEG_512x512_Q90",0.52840909090909,70,61,73,54,258
"bread_BakedUV","bread_BakedUV_simpL1_qp11_qt10_decompJPEG_1024x1024_Q10",0.329545454545455,74,52,30,54,210
"lizard_BakedUV","lizard_BakedUV_simpL9_qp9_qt6_decompJPEG_1440x1440_Q75",0.43452380952381,13,2,1,6,22
"dino_retopo_uv","dino_retopo_uv_simpL6_qp9_qt8_decompJPEG_2048x2048_Q50",0.371951219512195,23,49,25,7,104
"bread_BakedUV","bread_BakedUV_simpL4_qp9_qt10_decompJPEG_712x712_Q25",0.31875,74,52,30,54,210
"PRI_Hepatus","PRI_Hepatus_simpL3_qp10_qt6_decompJPEG_2048x2048_Q25",0.839285714285715,57,40,52,40,189
"Lidded-Ewer_bakedUV","Lidded-Ewer_bakedUV_simpL4_qp9_qt9_decompJPEG_1440x1440_Q50",0.31547619047619,61,56,66,54,237
"Lidded-Ewer_bakedUV","Lidded-Ewer_bakedUV_simpL7_qp11_qt8_decompJPEG_512x512_Q25",0.343023255813953,61,56,66,54,237
"Flintlock_Pistol","Flintlock_Pistol_simpL3_qp8_qt7_decompJPEG_1440x1440_Q25",0.84090909090909,9,5,10,8,32
"PlaningMachine200K","PlaningMachine200K_simpL9_qp8_qt6_decompJPEG_2048x2048_Q25",0.61046511627907,60,62,67,58,247
"Lidded-Ewer_bakedUV","Lidded-Ewer_bakedUV_simpL5_qp9_qt10_decompJPEG_712x712_Q25",0.323863636363637,61,56,66,54,237
"bread_BakedUV","bread_BakedUV_simpL5_qp10_qt6_decompJPEG_2048x2048_Q50",0.704545454545455,74,52,30,54,210
"Triceratops_manifold","Triceratops_manifold_simpL4_qp8_qt6_decompJPEG_1024x1024_Q10",0.75,22,17,22,26,87
"Flintlock_Pistol","Flintlock_Pistol_simpL1_qp10_qt7_decompJPEG_2048x2048_Q90",0.40909090909091,9,5,10,8,32
"Flintlock_Pistol","Flintlock_Pistol_simpL6_qp7_qt6_decompJPEG_2048x2048_Q25",0.96875,9,5,10,8,32
"Triceratops_manifold","Triceratops_manifold_simpL9_qp9_qt10_decompJPEG_2048x2048_Q50",0.176829268292682,22,17,22,26,87
"PRI_Hepatus","PRI_Hepatus_simpL3_qp7_qt6_decompJPEG_2048x2048_Q10",0.99404761904762,57,40,52,40,189
"PlaningMachine200K","PlaningMachine200K_simpL9_qp8_qt6_decompJPEG_712x712_Q25",0.593023255813953,60,62,67,58,247
"dorfkirche","dorfkirche_simpL7_qp11_qt8_decompJPEG_712x712_Q10",0.273255813953488,70,61,73,54,258
"bread_BakedUV","bread_BakedUV_simpL2_qp10_qt7_decompJPEG_2048x2048_Q50",0.416666666666668,74,52,30,54,210
"Triceratops_manifold","Triceratops_manifold_simpL9_qp7_qt10_decompJPEG_512x512_Q50",0.579268292682927,22,17,22,26,87
"Flintlock_Pistol","Flintlock_Pistol_simpL5_qp7_qt6_decompJPEG_2048x2048_Q10",0.948863636363638,9,5,10,8,32
"bread_BakedUV","bread_BakedUV_simpL9_qp9_qt7_decompJPEG_2048x2048_Q25",0.65,74,52,30,54,210
"Orchid","Orchid_simpL8_qp8_qt6_decompJPEG_1024x1024_Q75",0.444444444444445,70,72,43,82,267
"PlaningMachine200K","PlaningMachine200K_simpL9_qp8_qt6_decompJPEG_2048x2048_Q75",0.656976744186047,60,62,67,58,247
"shark_bakedUV","shark_bakedUV_simpL10_qp11_qt6_decompJPEG_1440x1440_Q90",0.755813953488373,22,21,15,28,86
"bread_BakedUV","bread_BakedUV_simpL1_qp10_qt9_decompJPEG_2048x2048_Q90",0.19047619047619,74,52,30,54,210
"dorfkirche","dorfkirche_simpL6_qp10_qt6_decompJPEG_512x512_Q25",0.827380952380953,70,61,73,54,258
"lizard_BakedUV","lizard_BakedUV_simpL10_qp7_qt10_decompJPEG_1440x1440_Q10",0.784883720930233,13,2,1,6,22
"PRI_Hepatus","PRI_Hepatus_simpL4_qp9_qt7_decompJPEG_1024x1024_Q90",0.66860465116279,57,40,52,40,189
"dino_retopo_uv","dino_retopo_uv_simpL5_qp9_qt10_decompJPEG_2048x2048_Q10",0.30232558139535,23,49,25,7,104
"Flintlock_Pistol","Flintlock_Pistol_simpL4_qp7_qt8_decompJPEG_1024x1024_Q25",0.98170731707317,9,5,10,8,32
"Orchid","Orchid_simpL9_qp11_qt9_decompJPEG_1440x1440_Q90",0.145348837209303,70,72,43,82,267
"Flintlock_Pistol","Flintlock_Pistol_simpL6_qp7_qt10_decompJPEG_1024x1024_Q50",0.94767441860465,9,5,10,8,32
"bread_BakedUV","bread_BakedUV_simpL7_qp7_qt7_decompJPEG_2048x2048_Q75",0.613095238095237,74,52,30,54,210
"PRI_Hepatus","PRI_Hepatus_simpL6_qp8_qt10_decompJPEG_1024x1024_Q25",0.636904761904763,57,40,52,40,189
"Lidded-Ewer_bakedUV","Lidded-Ewer_bakedUV_simpL8_qp11_qt8_decompJPEG_1024x1024_Q90",0.395348837209302,61,56,66,54,237
"Triceratops_manifold","Triceratops_manifold_simpL6_qp10_qt7_decompJPEG_712x712_Q25",0.220238095238095,22,17,22,26,87
"lizard_BakedUV","lizard_BakedUV_simpL10_qp7_qt8_decompJPEG_712x712_Q90",0.75,13,2,1,6,22
"bread_BakedUV","bread_BakedUV_simpL5_qp10_qt6_decompJPEG_2048x2048_Q90",0.7625,74,52,30,54,210
"Flintlock_Pistol","Flintlock_Pistol_simpL6_qp7_qt9_decompJPEG_2048x2048_Q90",0.959302325581395,9,5,10,8,32
"Lidded-Ewer_bakedUV","Lidded-Ewer_bakedUV_simpL6_qp11_qt8_decompJPEG_512x512_Q10",0.446428571428573,61,56,66,54,237
"lizard_BakedUV","lizard_BakedUV_simpL3_qp8_qt8_decompJPEG_712x712_Q10",0.681818181818183,13,2,1,6,22
"Orchid","Orchid_simpL9_qp8_qt7_decompJPEG_1024x1024_Q50",0.29375,70,72,43,82,267
"Triceratops_manifold","Triceratops_manifold_simpL3_qp11_qt6_decompJPEG_512x512_Q50",0.30952380952381,22,17,22,26,87
"PlaningMachine200K","PlaningMachine200K_simpL1_qp11_qt10_decompJPEG_2048x2048_Q90",0.208333333333333,60,62,67,58,247
"Triceratops_manifold","Triceratops_manifold_simpL9_qp7_qt9_decompJPEG_2048x2048_Q90",0.58139534883721,22,17,22,26,87
"Flintlock_Pistol","Flintlock_Pistol_simpL1_qp8_qt7_decompJPEG_2048x2048_Q75",0.872093023255815,9,5,10,8,32
"PlaningMachine200K","PlaningMachine200K_simpL8_qp8_qt10_decompJPEG_512x512_Q50",0.477272727272728,60,62,67,58,247
"Lidded-Ewer_bakedUV","Lidded-Ewer_bakedUV_simpL8_qp9_qt6_decompJPEG_1440x1440_Q25",0.823863636363638,61,56,66,54,237
"Triceratops_manifold","Triceratops_manifold_simpL9_qp7_qt9_decompJPEG_712x712_Q50",0.569767441860465,22,17,22,26,87
"lizard_BakedUV","lizard_BakedUV_simpL5_qp10_qt6_decompJPEG_1024x1024_Q10",0.476190476190475,13,2,1,6,22
"shark_bakedUV","shark_bakedUV_simpL1_qp11_qt9_decompJPEG_712x712_Q90",0.289772727272728,22,21,15,28,86
"shark_bakedUV","shark_bakedUV_simpL9_qp11_qt6_decompJPEG_1024x1024_Q25",0.83125,22,21,15,28,86
"PRI_Hepatus","PRI_Hepatus_simpL6_qp8_qt10_decompJPEG_2048x2048_Q25",0.58139534883721,57,40,52,40,189
"Lidded-Ewer_bakedUV","Lidded-Ewer_bakedUV_simpL1_qp11_qt10_decompJPEG_1024x1024_Q25",0.0722222222222224,61,56,66,54,237
"Lidded-Ewer_bakedUV","Lidded-Ewer_bakedUV_simpL7_qp11_qt10_decompJPEG_1024x1024_Q25",0.255681818181817,61,56,66,54,237
"PlaningMachine200K","PlaningMachine200K_simpL10_qp7_qt7_decompJPEG_2048x2048_Q75",0.953488372093023,60,62,67,58,247
"PlaningMachine200K","PlaningMachine200K_simpL9_qp8_qt6_decompJPEG_712x712_Q10",0.58125,60,62,67,58,247
"dino_retopo_uv","dino_retopo_uv_simpL7_qp10_qt6_decompJPEG_2048x2048_Q10",0.80232558139535,23,49,25,7,104
"dino_retopo_uv","dino_retopo_uv_simpL10_qp10_qt10_decompJPEG_1024x1024_Q90",0.785714285714285,23,49,25,7,104
"bread_BakedUV","bread_BakedUV_simpL4_qp11_qt7_decompJPEG_1440x1440_Q50",0.41111111111111,74,52,30,54,210
"shark_bakedUV","shark_bakedUV_simpL10_qp7_qt6_decompJPEG_1024x1024_Q75",0.895348837209302,22,21,15,28,86
"bread_BakedUV","bread_BakedUV_simpL4_qp10_qt9_decompJPEG_712x712_Q25",0.386904761904763,74,52,30,54,210
"shark_bakedUV","shark_bakedUV_simpL10_qp8_qt6_decompJPEG_712x712_Q25",0.80625,22,21,15,28,86
"dorfkirche","dorfkirche_simpL9_qp11_qt9_decompJPEG_512x512_Q50",0.238095238095237,70,61,73,54,258
"Triceratops_manifold","Triceratops_manifold_simpL5_qp8_qt6_decompJPEG_712x712_Q25",0.677777777777777,22,17,22,26,87
"Flintlock_Pistol","Flintlock_Pistol_simpL10_qp8_qt10_decompJPEG_1440x1440_Q75",0.704545454545455,9,5,10,8,32
"Triceratops_manifold","Triceratops_manifold_simpL3_qp9_qt8_decompJPEG_712x712_Q75",0.237179487179487,22,17,22,26,87
"Triceratops_manifold","Triceratops_manifold_simpL9_qp7_qt9_decompJPEG_1440x1440_Q75",0.704545454545455,22,17,22,26,87
"dorfkirche","dorfkirche_simpL8_qp11_qt10_decompJPEG_512x512_Q50",0.209302325581395,70,61,73,54,258
"Flintlock_Pistol","Flintlock_Pistol_simpL6_qp7_qt10_decompJPEG_1440x1440_Q75",0.988636363636362,9,5,10,8,32
"bread_BakedUV","bread_BakedUV_simpL7_qp8_qt8_decompJPEG_2048x2048_Q90",0.571428571428573,74,52,30,54,210
"Flintlock_Pistol","Flintlock_Pistol_simpL3_qp7_qt6_decompJPEG_1440x1440_Q25",0.975,9,5,10,8,32
"dorfkirche","dorfkirche_simpL9_qp11_qt8_decompJPEG_512x512_Q25",0.405555555555555,70,61,73,54,258
"Triceratops_manifold","Triceratops_manifold_simpL9_qp7_qt9_decompJPEG_512x512_Q25",0.654761904761905,22,17,22,26,87
"Lidded-Ewer_bakedUV","Lidded-Ewer_bakedUV_simpL7_qp9_qt8_decompJPEG_512x512_Q25",0.430232558139535,61,56,66,54,237
"lizard_BakedUV","lizard_BakedUV_simpL9_qp10_qt8_decompJPEG_2048x2048_Q75",0.238636363636362,13,2,1,6,22
"PlaningMachine200K","PlaningMachine200K_simpL8_qp9_qt8_decompJPEG_1024x1024_Q90",0.267045454545455,60,62,67,58,247
"shark_bakedUV","shark_bakedUV_simpL10_qp9_qt10_decompJPEG_2048x2048_Q10",0.609756097560975,22,21,15,28,86
"bread_BakedUV","bread_BakedUV_simpL7_qp7_qt7_decompJPEG_1440x1440_Q90",0.607142857142858,74,52,30,54,210
"Orchid","Orchid_simpL9_qp8_qt7_decompJPEG_1440x1440_Q25",0.227272727272728,70,72,43,82,267
"Orchid","Orchid_simpL9_qp11_qt7_decompJPEG_1024x1024_Q50",0.238095238095237,70,72,43,82,267
"PlaningMachine200K","PlaningMachine200K_simpL9_qp8_qt6_decompJPEG_1440x1440_Q90",0.696428571428573,60,62,67,58,247
"dorfkirche","dorfkirche_simpL4_qp9_qt10_decompJPEG_1440x1440_Q75",0.232558139534883,70,61,73,54,258
"PlaningMachine200K","PlaningMachine200K_simpL8_qp9_qt10_decompJPEG_712x712_Q90",0.277777777777777,60,62,67,58,247
"dorfkirche","dorfkirche_simpL7_qp11_qt10_decompJPEG_512x512_Q50",0.162790697674418,70,61,73,54,258
"PlaningMachine200K","PlaningMachine200K_simpL1_qp7_qt7_decompJPEG_512x512_Q10",0.755813953488373,60,62,67,58,247
"lizard_BakedUV","lizard_BakedUV_simpL9_qp9_qt6_decompJPEG_1440x1440_Q50",0.535714285714285,13,2,1,6,22
"shark_bakedUV","shark_bakedUV_simpL10_qp9_qt10_decompJPEG_2048x2048_Q25",0.556818181818183,22,21,15,28,86
"Lidded-Ewer_bakedUV","Lidded-Ewer_bakedUV_simpL7_qp11_qt9_decompJPEG_512x512_Q25",0.33974358974359,61,56,66,54,237
"Lidded-Ewer_bakedUV","Lidded-Ewer_bakedUV_simpL5_qp10_qt7_decompJPEG_512x512_Q75",0.209302325581395,61,56,66,54,237
"Orchid","Orchid_simpL9_qp8_qt7_decompJPEG_2048x2048_Q10",0.267441860465118,70,72,43,82,267
"Triceratops_manifold","Triceratops_manifold_simpL9_qp11_qt10_decompJPEG_1440x1440_Q75",0.122093023255815,22,17,22,26,87
"Flintlock_Pistol","Flintlock_Pistol_simpL5_qp7_qt10_decompJPEG_2048x2048_Q25",0.976744186046512,9,5,10,8,32
"PlaningMachine200K","PlaningMachine200K_simpL7_qp11_qt6_decompJPEG_512x512_Q75",0.306818181818183,60,62,67,58,247
"PRI_Hepatus","PRI_Hepatus_simpL6_qp8_qt10_decompJPEG_2048x2048_Q90",0.616279069767443,57,40,52,40,189
"shark_bakedUV","shark_bakedUV_simpL5_qp10_qt10_decompJPEG_712x712_Q50",0.431818181818183,22,21,15,28,86
"Triceratops_manifold","Triceratops_manifold_simpL9_qp7_qt9_decompJPEG_1024x1024_Q90",0.55813953488372,22,17,22,26,87
"PRI_Hepatus","PRI_Hepatus_simpL1_qp11_qt8_decompJPEG_512x512_Q50",0.296511627906977,57,40,52,40,189
"Flintlock_Pistol","Flintlock_Pistol_simpL9_qp11_qt6_decompJPEG_1440x1440_Q25",0.517045454545455,9,5,10,8,32
"Triceratops_manifold","Triceratops_manifold_simpL3_qp11_qt6_decompJPEG_512x512_Q75",0.261904761904763,22,17,22,26,87
"PlaningMachine200K","PlaningMachine200K_simpL2_qp9_qt9_decompJPEG_1024x1024_Q90",0.24404761904762,60,62,67,58,247
"bread_BakedUV","bread_BakedUV_simpL8_qp11_qt7_decompJPEG_2048x2048_Q50",0.53125,74,52,30,54,210
"dorfkirche","dorfkirche_simpL5_qp9_qt9_decompJPEG_2048x2048_Q50",0.232558139534883,70,61,73,54,258
"dorfkirche","dorfkirche_simpL2_qp10_qt7_decompJPEG_2048x2048_Q25",0.664772727272728,70,61,73,54,258
"dino_retopo_uv","dino_retopo_uv_simpL6_qp11_qt6_decompJPEG_712x712_Q50",0.738636363636363,23,49,25,7,104
"shark_bakedUV","shark_bakedUV_simpL10_qp7_qt6_decompJPEG_1440x1440_Q90",0.898809523809525,22,21,15,28,86
"Flintlock_Pistol","Flintlock_Pistol_simpL1_qp9_qt6_decompJPEG_712x712_Q90",0.68452380952381,9,5,10,8,32
"PRI_Hepatus","PRI_Hepatus_simpL4_qp9_qt7_decompJPEG_512x512_Q10",0.705555555555555,57,40,52,40,189
"lizard_BakedUV","lizard_BakedUV_simpL10_qp7_qt6_decompJPEG_1440x1440_Q90",0.78409090909091,13,2,1,6,22
"Orchid","Orchid_simpL9_qp8_qt8_decompJPEG_2048x2048_Q10",0.22560975609756,70,72,43,82,267
"dorfkirche","dorfkirche_simpL2_qp9_qt10_decompJPEG_512x512_Q10",0.541666666666668,70,61,73,54,258
"Triceratops_manifold","Triceratops_manifold_simpL2_qp11_qt6_decompJPEG_512x512_Q75",0.238636363636362,22,17,22,26,87
"Flintlock_Pistol","Flintlock_Pistol_simpL5_qp7_qt9_decompJPEG_2048x2048_Q50",0.98780487804878,9,5,10,8,32
"lizard_BakedUV","lizard_BakedUV_simpL6_qp11_qt6_decompJPEG_1024x1024_Q75",0.38888888888889,13,2,1,6,22
"Orchid","Orchid_simpL3_qp10_qt6_decompJPEG_512x512_Q25",0.3875,70,72,43,82,267
"shark_bakedUV","shark_bakedUV_simpL10_qp9_qt10_decompJPEG_1440x1440_Q10",0.73780487804878,22,21,15,28,86
"Lidded-Ewer_bakedUV","Lidded-Ewer_bakedUV_simpL5_qp9_qt10_decompJPEG_1440x1440_Q25",0.244186046511627,61,56,66,54,237
"dino_retopo_uv","dino_retopo_uv_simpL7_qp10_qt6_decompJPEG_712x712_Q50",0.681818181818183,23,49,25,7,104
"PlaningMachine200K","PlaningMachine200K_simpL7_qp11_qt6_decompJPEG_512x512_Q90",0.291666666666668,60,62,67,58,247
"dino_retopo_uv","dino_retopo_uv_simpL6_qp9_qt10_decompJPEG_512x512_Q75",0.176136363636362,23,49,25,7,104
"Orchid","Orchid_simpL7_qp10_qt6_decompJPEG_712x712_Q50",0.345238095238095,70,72,43,82,267
"Lidded-Ewer_bakedUV","Lidded-Ewer_bakedUV_simpL1_qp11_qt8_decompJPEG_712x712_Q25",0.1,61,56,66,54,237
"Triceratops_manifold","Triceratops_manifold_simpL9_qp10_qt9_decompJPEG_1024x1024_Q25",0.151162790697675,22,17,22,26,87
"PlaningMachine200K","PlaningMachine200K_simpL7_qp11_qt6_decompJPEG_1024x1024_Q50",0.363636363636363,60,62,67,58,247
"dorfkirche","dorfkirche_simpL6_qp7_qt9_decompJPEG_2048x2048_Q10",0.977272727272728,70,61,73,54,258
"PRI_Hepatus","PRI_Hepatus_simpL7_qp8_qt9_decompJPEG_2048x2048_Q10",0.6,57,40,52,40,189
"shark_bakedUV","shark_bakedUV_simpL10_qp11_qt6_decompJPEG_1024x1024_Q75",0.761627906976745,22,21,15,28,86
"PlaningMachine200K","PlaningMachine200K_simpL10_qp7_qt7_decompJPEG_2048x2048_Q90",0.96590909090909,60,62,67,58,247
"bread_BakedUV","bread_BakedUV_simpL3_qp11_qt9_decompJPEG_512x512_Q90",0.244186046511627,74,52,30,54,210
"Orchid","Orchid_simpL9_qp10_qt7_decompJPEG_712x712_Q25",0.25,70,72,43,82,267
"dorfkirche","dorfkirche_simpL8_qp11_qt10_decompJPEG_512x512_Q90",0.0909090909090899,70,61,73,54,258
"Triceratops_manifold","Triceratops_manifold_simpL2_qp10_qt6_decompJPEG_512x512_Q75",0.3125,22,17,22,26,87
"Flintlock_Pistol","Flintlock_Pistol_simpL5_qp7_qt6_decompJPEG_1024x1024_Q10",0.982558139534883,9,5,10,8,32
"Lidded-Ewer_bakedUV","Lidded-Ewer_bakedUV_simpL4_qp11_qt8_decompJPEG_512x512_Q25",0.203488372093023,61,56,66,54,237
"PRI_Hepatus","PRI_Hepatus_simpL5_qp9_qt7_decompJPEG_512x512_Q50",0.619318181818183,57,40,52,40,189
"dorfkirche","dorfkirche_simpL9_qp11_qt10_decompJPEG_2048x2048_Q10",0.13125,70,61,73,54,258
"PlaningMachine200K","PlaningMachine200K_simpL9_qp8_qt6_decompJPEG_2048x2048_Q10",0.625,60,62,67,58,247
"PlaningMachine200K","PlaningMachine200K_simpL2_qp7_qt6_decompJPEG_512x512_Q25",0.80232558139535,60,62,67,58,247
"lizard_BakedUV","lizard_BakedUV_simpL10_qp7_qt7_decompJPEG_1024x1024_Q25",0.773255813953488,13,2,1,6,22
"PlaningMachine200K","PlaningMachine200K_simpL9_qp10_qt6_decompJPEG_712x712_Q25",0.392045454545455,60,62,67,58,247
"bread_BakedUV","bread_BakedUV_simpL7_qp11_qt10_decompJPEG_712x712_Q50",0.458333333333332,74,52,30,54,210
"Lidded-Ewer_bakedUV","Lidded-Ewer_bakedUV_simpL5_qp11_qt10_decompJPEG_2048x2048_Q90",0.154761904761905,61,56,66,54,237
"lizard_BakedUV","lizard_BakedUV_simpL10_qp7_qt6_decompJPEG_512x512_Q10",0.880681818181817,13,2,1,6,22
"dorfkirche","dorfkirche_simpL4_qp9_qt8_decompJPEG_1440x1440_Q25",0.406976744186047,70,61,73,54,258
"bread_BakedUV","bread_BakedUV_simpL9_qp7_qt7_decompJPEG_2048x2048_Q75",0.676136363636363,74,52,30,54,210
"Lidded-Ewer_bakedUV","Lidded-Ewer_bakedUV_simpL1_qp11_qt10_decompJPEG_2048x2048_Q90",0.05,61,56,66,54,237
"bread_BakedUV","bread_BakedUV_simpL4_qp10_qt10_decompJPEG_712x712_Q50",0.238372093023255,74,52,30,54,210
"dorfkirche","dorfkirche_simpL10_qp11_qt6_decompJPEG_2048x2048_Q10",0.952380952380953,70,61,73,54,258
"Triceratops_manifold","Triceratops_manifold_simpL4_qp10_qt8_decompJPEG_1024x1024_Q25",0.136363636363638,22,17,22,26,87
"PlaningMachine200K","PlaningMachine200K_simpL7_qp9_qt6_decompJPEG_1440x1440_Q25",0.453488372093023,60,62,67,58,247
"bread_BakedUV","bread_BakedUV_simpL1_qp9_qt7_decompJPEG_1440x1440_Q75",0.430232558139535,74,52,30,54,210
"PlaningMachine200K","PlaningMachine200K_simpL7_qp10_qt6_decompJPEG_512x512_Q75",0.401162790697675,60,62,67,58,247
"PlaningMachine200K","PlaningMachine200K_simpL1_qp10_qt10_decompJPEG_712x712_Q75",0.134146341463415,60,62,67,58,247
"shark_bakedUV","shark_bakedUV_simpL3_qp11_qt10_decompJPEG_1024x1024_Q75",0.166666666666667,22,21,15,28,86
"bread_BakedUV","bread_BakedUV_simpL7_qp10_qt9_decompJPEG_1024x1024_Q50",0.472222222222223,74,52,30,54,210
"Flintlock_Pistol","Flintlock_Pistol_simpL4_qp8_qt7_decompJPEG_1440x1440_Q90",0.854651162790698,9,5,10,8,32
"PRI_Hepatus","PRI_Hepatus_simpL2_qp11_qt8_decompJPEG_512x512_Q90",0.404761904761905,57,40,52,40,189
"lizard_BakedUV","lizard_BakedUV_simpL6_qp11_qt6_decompJPEG_712x712_Q50",0.431818181818183,13,2,1,6,22
"PRI_Hepatus","PRI_Hepatus_simpL2_qp11_qt7_decompJPEG_512x512_Q75",0.66860465116279,57,40,52,40,189
"lizard_BakedUV","lizard_BakedUV_simpL10_qp7_qt6_decompJPEG_2048x2048_Q90",0.857142857142857,13,2,1,6,22
"lizard_BakedUV","lizard_BakedUV_simpL6_qp10_qt6_decompJPEG_712x712_Q10",0.511627906976745,13,2,1,6,22
"PlaningMachine200K","PlaningMachine200K_simpL5_qp7_qt10_decompJPEG_2048x2048_Q25",0.68452380952381,60,62,67,58,247
"lizard_BakedUV","lizard_BakedUV_simpL8_qp8_qt7_decompJPEG_712x712_Q90",0.648809523809525,13,2,1,6,22
"Triceratops_manifold","Triceratops_manifold_simpL2_qp9_qt6_decompJPEG_512x512_Q75",0.46875,22,17,22,26,87
"lizard_BakedUV","lizard_BakedUV_simpL10_qp7_qt6_decompJPEG_2048x2048_Q50",0.821428571428573,13,2,1,6,22
"PRI_Hepatus","PRI_Hepatus_simpL2_qp10_qt10_decompJPEG_512x512_Q10",0.432926829268293,57,40,52,40,189
"PRI_Hepatus","PRI_Hepatus_simpL1_qp9_qt10_decompJPEG_712x712_Q10",0.433333333333332,57,40,52,40,189
"bread_BakedUV","bread_BakedUV_simpL5_qp8_qt6_decompJPEG_2048x2048_Q50",0.738372093023255,74,52,30,54,210
"PlaningMachine200K","PlaningMachine200K_simpL3_qp9_qt7_decompJPEG_1024x1024_Q90",0.337209302325583,60,62,67,58,247
"shark_bakedUV","shark_bakedUV_simpL10_qp9_qt6_decompJPEG_1440x1440_Q10",0.80232558139535,22,21,15,28,86
"PRI_Hepatus","PRI_Hepatus_simpL5_qp7_qt10_decompJPEG_2048x2048_Q75",0.960227272727272,57,40,52,40,189
"dorfkirche","dorfkirche_simpL9_qp11_qt10_decompJPEG_512x512_Q90",0.1625,70,61,73,54,258
"PRI_Hepatus","PRI_Hepatus_simpL6_qp8_qt9_decompJPEG_512x512_Q90",0.625,57,40,52,40,189
"Flintlock_Pistol","Flintlock_Pistol_simpL5_qp7_qt6_decompJPEG_1440x1440_Q25",0.988636363636362,9,5,10,8,32
"bread_BakedUV","bread_BakedUV_simpL5_qp8_qt10_decompJPEG_512x512_Q10",0.545454545454545,74,52,30,54,210
"dorfkirche","dorfkirche_simpL9_qp11_qt10_decompJPEG_512x512_Q75",0.125,70,61,73,54,258
"dino_retopo_uv","dino_retopo_uv_simpL4_qp9_qt8_decompJPEG_1024x1024_Q10",0.244186046511627,23,49,25,7,104
"PlaningMachine200K","PlaningMachine200K_simpL9_qp10_qt10_decompJPEG_512x512_Q75",0.232142857142857,60,62,67,58,247
"Triceratops_manifold","Triceratops_manifold_simpL3_qp9_qt6_decompJPEG_512x512_Q75",0.443181818181817,22,17,22,26,87
"Orchid","Orchid_simpL9_qp8_qt7_decompJPEG_712x712_Q50",0.25,70,72,43,82,267
"Lidded-Ewer_bakedUV","Lidded-Ewer_bakedUV_simpL1_qp9_qt8_decompJPEG_512x512_Q50",0.232558139534883,61,56,66,54,237
"PRI_Hepatus","PRI_Hepatus_simpL2_qp10_qt8_decompJPEG_1440x1440_Q75",0.375,57,40,52,40,189
"dino_retopo_uv","dino_retopo_uv_simpL4_qp10_qt6_decompJPEG_512x512_Q25",0.69047619047619,23,49,25,7,104
"PRI_Hepatus","PRI_Hepatus_simpL6_qp10_qt8_decompJPEG_712x712_Q75",0.31578947368421,57,40,52,40,189
"Flintlock_Pistol","Flintlock_Pistol_simpL10_qp8_qt6_decompJPEG_1024x1024_Q25",0.7875,9,5,10,8,32
"Lidded-Ewer_bakedUV","Lidded-Ewer_bakedUV_simpL7_qp10_qt8_decompJPEG_712x712_Q50",0.375,61,56,66,54,237
"Triceratops_manifold","Triceratops_manifold_simpL9_qp7_qt8_decompJPEG_2048x2048_Q75",0.622093023255815,22,17,22,26,87
"dorfkirche","dorfkirche_simpL7_qp9_qt10_decompJPEG_1024x1024_Q25",0.30232558139535,70,61,73,54,258
"Flintlock_Pistol","Flintlock_Pistol_simpL10_qp7_qt6_decompJPEG_1440x1440_Q25",0.883333333333333,9,5,10,8,32
"Orchid","Orchid_simpL9_qp11_qt9_decompJPEG_2048x2048_Q90",0.210227272727272,70,72,43,82,267
"dorfkirche","dorfkirche_simpL9_qp10_qt8_decompJPEG_1024x1024_Q10",0.395348837209302,70,61,73,54,258
"shark_bakedUV","shark_bakedUV_simpL10_qp9_qt6_decompJPEG_712x712_Q25",0.755813953488373,22,21,15,28,86
"bread_BakedUV","bread_BakedUV_simpL9_qp7_qt9_decompJPEG_2048x2048_Q75",0.680232558139535,74,52,30,54,210
"PlaningMachine200K","PlaningMachine200K_simpL9_qp8_qt6_decompJPEG_1440x1440_Q50",0.622222222222222,60,62,67,58,247
"shark_bakedUV","shark_bakedUV_simpL9_qp11_qt6_decompJPEG_712x712_Q50",0.796511627906977,22,21,15,28,86
"lizard_BakedUV","lizard_BakedUV_simpL10_qp7_qt6_decompJPEG_1440x1440_Q10",0.83125,13,2,1,6,22
"Lidded-Ewer_bakedUV","Lidded-Ewer_bakedUV_simpL6_qp10_qt8_decompJPEG_2048x2048_Q25",0.279761904761905,61,56,66,54,237
"Triceratops_manifold","Triceratops_manifold_simpL9_qp10_qt10_decompJPEG_512x512_Q10",0.261363636363637,22,17,22,26,87
"PRI_Hepatus","PRI_Hepatus_simpL7_qp8_qt10_decompJPEG_712x712_Q90",0.613636363636363,57,40,52,40,189
"dorfkirche","dorfkirche_simpL8_qp11_qt10_decompJPEG_512x512_Q75",0.0852272727272725,70,61,73,54,258
"PRI_Hepatus","PRI_Hepatus_simpL4_qp11_qt8_decompJPEG_512x512_Q90",0.357142857142858,57,40,52,40,189
"Flintlock_Pistol","Flintlock_Pistol_simpL3_qp10_qt10_decompJPEG_1024x1024_Q50",0.208333333333333,9,5,10,8,32
"shark_bakedUV","shark_bakedUV_simpL1_qp11_qt10_decompJPEG_712x712_Q50",0.25609756097561,22,21,15,28,86
"bread_BakedUV","bread_BakedUV_simpL4_qp11_qt10_decompJPEG_712x712_Q25",0.31875,74,52,30,54,210
"Orchid","Orchid_simpL2_qp10_qt6_decompJPEG_1440x1440_Q10",0.384615384615385,70,72,43,82,267
"PRI_Hepatus","PRI_Hepatus_simpL1_qp9_qt7_decompJPEG_512x512_Q10",0.732954545454545,57,40,52,40,189
"bread_BakedUV","bread_BakedUV_simpL3_qp11_qt9_decompJPEG_712x712_Q25",0.34659090909091,74,52,30,54,210
"dino_retopo_uv","dino_retopo_uv_simpL7_qp9_qt8_decompJPEG_1440x1440_Q10",0.348837209302325,23,49,25,7,104
"PRI_Hepatus","PRI_Hepatus_simpL1_qp11_qt8_decompJPEG_712x712_Q25",0.397727272727272,57,40,52,40,189
"Orchid","Orchid_simpL9_qp11_qt7_decompJPEG_2048x2048_Q75",0.133720930232557,70,72,43,82,267
"dorfkirche","dorfkirche_simpL4_qp9_qt10_decompJPEG_2048x2048_Q25",0.2625,70,61,73,54,258
"lizard_BakedUV","lizard_BakedUV_simpL10_qp7_qt6_decompJPEG_712x712_Q90",0.779761904761905,13,2,1,6,22
"Triceratops_manifold","Triceratops_manifold_simpL5_qp10_qt8_decompJPEG_512x512_Q50",0.13095238095238,22,17,22,26,87
"lizard_BakedUV","lizard_BakedUV_simpL10_qp7_qt7_decompJPEG_1024x1024_Q90",0.755555555555555,13,2,1,6,22
"bread_BakedUV","bread_BakedUV_simpL3_qp11_qt7_decompJPEG_1024x1024_Q90",0.430232558139535,74,52,30,54,210
"shark_bakedUV","shark_bakedUV_simpL1_qp11_qt10_decompJPEG_512x512_Q75",0.327380952380953,22,21,15,28,86
"shark_bakedUV","shark_bakedUV_simpL10_qp9_qt6_decompJPEG_2048x2048_Q90",0.848837209302325,22,21,15,28,86
"dino_retopo_uv","dino_retopo_uv_simpL1_qp9_qt9_decompJPEG_1440x1440_Q10",0.238372093023255,23,49,25,7,104
"Orchid","Orchid_simpL9_qp8_qt7_decompJPEG_712x712_Q10",0.378048780487805,70,72,43,82,267
"dorfkirche","dorfkirche_simpL3_qp11_qt10_decompJPEG_512x512_Q50",0.176829268292682,70,61,73,54,258
"lizard_BakedUV","lizard_BakedUV_simpL8_qp8_qt8_decompJPEG_1024x1024_Q25",0.566666666666668,13,2,1,6,22
"lizard_BakedUV","lizard_BakedUV_simpL8_qp11_qt7_decompJPEG_712x712_Q90",0.30625,13,2,1,6,22
"Flintlock_Pistol","Flintlock_Pistol_simpL5_qp7_qt6_decompJPEG_2048x2048_Q90",0.976190476190475,9,5,10,8,32
"shark_bakedUV","shark_bakedUV_simpL10_qp9_qt6_decompJPEG_1440x1440_Q25",0.803571428571427,22,21,15,28,86
"bread_BakedUV","bread_BakedUV_simpL6_qp11_qt10_decompJPEG_712x712_Q25",0.426829268292683,74,52,30,54,210
"PRI_Hepatus","PRI_Hepatus_simpL7_qp10_qt7_decompJPEG_512x512_Q50",0.591463414634148,57,40,52,40,189
"PRI_Hepatus","PRI_Hepatus_simpL1_qp9_qt9_decompJPEG_512x512_Q10",0.439024390243902,57,40,52,40,189
"lizard_BakedUV","lizard_BakedUV_simpL10_qp7_qt6_decompJPEG_1024x1024_Q10",0.803571428571427,13,2,1,6,22
"Flintlock_Pistol","Flintlock_Pistol_simpL6_qp7_qt9_decompJPEG_1440x1440_Q75",0.982954545454545,9,5,10,8,32
"dino_retopo_uv","dino_retopo_uv_simpL10_qp9_qt9_decompJPEG_1024x1024_Q90",0.819767441860465,23,49,25,7,104
"bread_BakedUV","bread_BakedUV_simpL2_qp11_qt7_decompJPEG_2048x2048_Q25",0.380681818181817,74,52,30,54,210
"Triceratops_manifold","Triceratops_manifold_simpL2_qp9_qt6_decompJPEG_712x712_Q75",0.401162790697675,22,17,22,26,87
"dorfkirche","dorfkirche_simpL5_qp9_qt9_decompJPEG_1024x1024_Q10",0.352272727272728,70,61,73,54,258
"bread_BakedUV","bread_BakedUV_simpL5_qp7_qt6_decompJPEG_2048x2048_Q10",0.848837209302325,74,52,30,54,210
"dino_retopo_uv","dino_retopo_uv_simpL3_qp11_qt6_decompJPEG_2048x2048_Q10",0.8875,23,49,25,7,104
"Orchid","Orchid_simpL2_qp11_qt6_decompJPEG_2048x2048_Q75",0.3125,70,72,43,82,267
"Flintlock_Pistol","Flintlock_Pistol_simpL10_qp10_qt7_decompJPEG_512x512_Q50",0.613095238095237,9,5,10,8,32
"Lidded-Ewer_bakedUV","Lidded-Ewer_bakedUV_simpL7_qp10_qt6_decompJPEG_512x512_Q90",0.6875,61,56,66,54,237
"lizard_BakedUV","lizard_BakedUV_simpL10_qp7_qt6_decompJPEG_712x712_Q75",0.80952380952381,13,2,1,6,22
"lizard_BakedUV","lizard_BakedUV_simpL10_qp7_qt8_decompJPEG_1024x1024_Q90",0.732142857142858,13,2,1,6,22
"PRI_Hepatus","PRI_Hepatus_simpL3_qp10_qt8_decompJPEG_512x512_Q90",0.375,57,40,52,40,189
"lizard_BakedUV","lizard_BakedUV_simpL8_qp8_qt10_decompJPEG_712x712_Q25",0.459302325581395,13,2,1,6,22
"lizard_BakedUV","lizard_BakedUV_simpL10_qp7_qt6_decompJPEG_1440x1440_Q75",0.835227272727272,13,2,1,6,22
"Lidded-Ewer_bakedUV","Lidded-Ewer_bakedUV_simpL9_qp11_qt7_decompJPEG_712x712_Q50",0.63125,61,56,66,54,237
"Flintlock_Pistol","Flintlock_Pistol_simpL1_qp8_qt6_decompJPEG_2048x2048_Q90",0.960526315789473,9,5,10,8,32
"Orchid","Orchid_simpL9_qp8_qt7_decompJPEG_2048x2048_Q50",0.28409090909091,70,72,43,82,267
"Lidded-Ewer_bakedUV","Lidded-Ewer_bakedUV_simpL3_qp9_qt10_decompJPEG_2048x2048_Q10",0.369318181818183,61,56,66,54,237
"PlaningMachine200K","PlaningMachine200K_simpL9_qp8_qt7_decompJPEG_512x512_Q50",0.523255813953488,60,62,67,58,247
"Lidded-Ewer_bakedUV","Lidded-Ewer_bakedUV_simpL9_qp10_qt7_decompJPEG_712x712_Q50",0.647435897435897,61,56,66,54,237
"lizard_BakedUV","lizard_BakedUV_simpL6_qp9_qt6_decompJPEG_1024x1024_Q25",0.511904761904763,13,2,1,6,22
"Lidded-Ewer_bakedUV","Lidded-Ewer_bakedUV_simpL8_qp11_qt6_decompJPEG_512x512_Q90",0.767045454545455,61,56,66,54,237
"Lidded-Ewer_bakedUV","Lidded-Ewer_bakedUV_simpL5_qp10_qt7_decompJPEG_512x512_Q50",0.261627906976745,61,56,66,54,237
"Flintlock_Pistol","Flintlock_Pistol_simpL10_qp11_qt6_decompJPEG_1024x1024_Q75",0.675,9,5,10,8,32
"Flintlock_Pistol","Flintlock_Pistol_simpL10_qp8_qt6_decompJPEG_512x512_Q50",0.797619047619047,9,5,10,8,32
"dino_retopo_uv","dino_retopo_uv_simpL7_qp7_qt6_decompJPEG_1024x1024_Q50",0.982142857142857,23,49,25,7,104
"Orchid","Orchid_simpL2_qp11_qt7_decompJPEG_1024x1024_Q75",0.0930232558139525,70,72,43,82,267
"Lidded-Ewer_bakedUV","Lidded-Ewer_bakedUV_simpL1_qp11_qt10_decompJPEG_2048x2048_Q50",0.0625,61,56,66,54,237
"dorfkirche","dorfkirche_simpL6_qp9_qt9_decompJPEG_1024x1024_Q75",0.25609756097561,70,61,73,54,258
"dorfkirche","dorfkirche_simpL9_qp9_qt8_decompJPEG_512x512_Q50",0.453488372093023,70,61,73,54,258
"lizard_BakedUV","lizard_BakedUV_simpL9_qp8_qt10_decompJPEG_712x712_Q90",0.5625,13,2,1,6,22
"PlaningMachine200K","PlaningMachine200K_simpL1_qp8_qt9_decompJPEG_1024x1024_Q90",0.49390243902439,60,62,67,58,247
"lizard_BakedUV","lizard_BakedUV_simpL10_qp7_qt10_decompJPEG_1440x1440_Q75",0.744186046511627,13,2,1,6,22
"dorfkirche","dorfkirche_simpL4_qp9_qt10_decompJPEG_2048x2048_Q75",0.273255813953488,70,61,73,54,258
"dorfkirche","dorfkirche_simpL4_qp9_qt10_decompJPEG_2048x2048_Q90",0.275641025641025,70,61,73,54,258
"Orchid","Orchid_simpL1_qp9_qt7_decompJPEG_512x512_Q75",0.152439024390245,70,72,43,82,267
"shark_bakedUV","shark_bakedUV_simpL10_qp9_qt10_decompJPEG_2048x2048_Q90",0.604651162790698,22,21,15,28,86
"lizard_BakedUV","lizard_BakedUV_simpL10_qp7_qt10_decompJPEG_512x512_Q25",0.796511627906977,13,2,1,6,22
"dorfkirche","dorfkirche_simpL2_qp10_qt6_decompJPEG_512x512_Q10",0.78409090909091,70,61,73,54,258
"Triceratops_manifold","Triceratops_manifold_simpL1_qp9_qt6_decompJPEG_512x512_Q75",0.454545454545455,22,17,22,26,87
"shark_bakedUV","shark_bakedUV_simpL3_qp10_qt9_decompJPEG_1440x1440_Q50",0.476190476190475,22,21,15,28,86
"dorfkirche","dorfkirche_simpL6_qp10_qt10_decompJPEG_1440x1440_Q25",0.170454545454545,70,61,73,54,258
"Triceratops_manifold","Triceratops_manifold_simpL9_qp8_qt7_decompJPEG_2048x2048_Q50",0.296511627906977,22,17,22,26,87
"Orchid","Orchid_simpL8_qp10_qt8_decompJPEG_1024x1024_Q50",0.22159090909091,70,72,43,82,267
"Lidded-Ewer_bakedUV","Lidded-Ewer_bakedUV_simpL8_qp11_qt8_decompJPEG_512x512_Q90",0.48125,61,56,66,54,237
"Orchid","Orchid_simpL9_qp8_qt9_decompJPEG_1440x1440_Q10",0.226190476190478,70,72,43,82,267
"Orchid","Orchid_simpL2_qp9_qt9_decompJPEG_512x512_Q50",0.1,70,72,43,82,267
"Orchid","Orchid_simpL9_qp11_qt9_decompJPEG_2048x2048_Q75",0.209302325581395,70,72,43,82,267
"Lidded-Ewer_bakedUV","Lidded-Ewer_bakedUV_simpL6_qp8_qt9_decompJPEG_1024x1024_Q75",0.645348837209302,61,56,66,54,237
"PRI_Hepatus","PRI_Hepatus_simpL6_qp10_qt8_decompJPEG_512x512_Q25",0.345238095238095,57,40,52,40,189
"dorfkirche","dorfkirche_simpL4_qp9_qt10_decompJPEG_1440x1440_Q90",0.325581395348837,70,61,73,54,258
"Triceratops_manifold","Triceratops_manifold_simpL9_qp7_qt10_decompJPEG_1024x1024_Q90",0.49404761904762,22,17,22,26,87
"shark_bakedUV","shark_bakedUV_simpL10_qp9_qt6_decompJPEG_2048x2048_Q50",0.80232558139535,22,21,15,28,86
"Orchid","Orchid_simpL1_qp11_qt7_decompJPEG_1024x1024_Q75",0.107954545454545,70,72,43,82,267
"bread_BakedUV","bread_BakedUV_simpL5_qp8_qt9_decompJPEG_712x712_Q25",0.348837209302325,74,52,30,54,210
"dino_retopo_uv","dino_retopo_uv_simpL2_qp9_qt9_decompJPEG_1024x1024_Q25",0.24375,23,49,25,7,104
"dino_retopo_uv","dino_retopo_uv_simpL4_qp9_qt8_decompJPEG_1440x1440_Q25",0.323863636363637,23,49,25,7,104
"shark_bakedUV","shark_bakedUV_simpL10_qp11_qt6_decompJPEG_2048x2048_Q50",0.726744186046512,22,21,15,28,86
"dorfkirche","dorfkirche_simpL1_qp9_qt9_decompJPEG_1440x1440_Q10",0.357954545454545,70,61,73,54,258
"dino_retopo_uv","dino_retopo_uv_simpL9_qp9_qt6_decompJPEG_512x512_Q50",0.66111111111111,23,49,25,7,104
"shark_bakedUV","shark_bakedUV_simpL9_qp10_qt6_decompJPEG_1024x1024_Q50",0.84090909090909,22,21,15,28,86
"lizard_BakedUV","lizard_BakedUV_simpL9_qp9_qt6_decompJPEG_1440x1440_Q90",0.517045454545455,13,2,1,6,22
"PlaningMachine200K","PlaningMachine200K_simpL2_qp8_qt6_decompJPEG_512x512_Q75",0.627777777777778,60,62,67,58,247
"Lidded-Ewer_bakedUV","Lidded-Ewer_bakedUV_simpL9_qp9_qt7_decompJPEG_712x712_Q25",0.63095238095238,61,56,66,54,237
"lizard_BakedUV","lizard_BakedUV_simpL10_qp7_qt6_decompJPEG_712x712_Q10",0.789772727272728,13,2,1,6,22
"Triceratops_manifold","Triceratops_manifold_simpL9_qp7_qt9_decompJPEG_1024x1024_Q75",0.59659090909091,22,17,22,26,87
"PRI_Hepatus","PRI_Hepatus_simpL2_qp11_qt8_decompJPEG_712x712_Q75",0.354651162790698,57,40,52,40,189
"Lidded-Ewer_bakedUV","Lidded-Ewer_bakedUV_simpL1_qp11_qt8_decompJPEG_512x512_Q25",0.140243902439025,61,56,66,54,237
"dino_retopo_uv","dino_retopo_uv_simpL9_qp8_qt10_decompJPEG_1440x1440_Q25",0.636904761904763,23,49,25,7,104
"shark_bakedUV","shark_bakedUV_simpL9_qp10_qt6_decompJPEG_2048x2048_Q50",0.863636363636362,22,21,15,28,86
"PlaningMachine200K","PlaningMachine200K_simpL9_qp8_qt6_decompJPEG_512x512_Q25",0.61904761904762,60,62,67,58,247
"dorfkirche","dorfkirche_simpL9_qp11_qt9_decompJPEG_1024x1024_Q10",0.26875,70,61,73,54,258
"bread_BakedUV","bread_BakedUV_simpL5_qp10_qt8_decompJPEG_512x512_Q10",0.579545454545455,74,52,30,54,210
"bread_BakedUV","bread_BakedUV_simpL1_qp11_qt10_decompJPEG_712x712_Q25",0.222222222222223,74,52,30,54,210
"PlaningMachine200K","PlaningMachine200K_simpL9_qp10_qt6_decompJPEG_1024x1024_Q90",0.46111111111111,60,62,67,58,247
"Orchid","Orchid_simpL9_qp8_qt7_decompJPEG_512x512_Q25",0.30813953488372,70,72,43,82,267
"PRI_Hepatus","PRI_Hepatus_simpL1_qp8_qt9_decompJPEG_2048x2048_Q50",0.65909090909091,57,40,52,40,189
"dorfkirche","dorfkirche_simpL2_qp10_qt9_decompJPEG_712x712_Q75",0.13953488372093,70,61,73,54,258
"dino_retopo_uv","dino_retopo_uv_simpL5_qp9_qt10_decompJPEG_1440x1440_Q10",0.284883720930233,23,49,25,7,104
"Flintlock_Pistol","Flintlock_Pistol_simpL7_qp8_qt6_decompJPEG_1024x1024_Q10",0.837209302325582,9,5,10,8,32
"Lidded-Ewer_bakedUV","Lidded-Ewer_bakedUV_simpL6_qp9_qt6_decompJPEG_2048x2048_Q25",0.658536585365852,61,56,66,54,237
"Lidded-Ewer_bakedUV","Lidded-Ewer_bakedUV_simpL1_qp11_qt9_decompJPEG_1024x1024_Q75",0.0755813953488376,61,56,66,54,237
"Lidded-Ewer_bakedUV","Lidded-Ewer_bakedUV_simpL8_qp9_qt6_decompJPEG_2048x2048_Q50",0.852272727272728,61,56,66,54,237
"lizard_BakedUV","lizard_BakedUV_simpL10_qp11_qt7_decompJPEG_2048x2048_Q50",0.571428571428573,13,2,1,6,22
"PlaningMachine200K","PlaningMachine200K_simpL7_qp10_qt8_decompJPEG_2048x2048_Q25",0.142045454545455,60,62,67,58,247
"Flintlock_Pistol","Flintlock_Pistol_simpL3_qp7_qt6_decompJPEG_1024x1024_Q10",0.99404761904762,9,5,10,8,32
"dorfkirche","dorfkirche_simpL8_qp11_qt9_decompJPEG_512x512_Q50",0.164634146341462,70,61,73,54,258
"lizard_BakedUV","lizard_BakedUV_simpL5_qp10_qt6_decompJPEG_1440x1440_Q25",0.430232558139535,13,2,1,6,22
"Orchid","Orchid_simpL9_qp11_qt7_decompJPEG_2048x2048_Q50",0.2,70,72,43,82,267
"PRI_Hepatus","PRI_Hepatus_simpL6_qp10_qt6_decompJPEG_1024x1024_Q50",0.821428571428573,57,40,52,40,189
"Triceratops_manifold","Triceratops_manifold_simpL5_qp8_qt8_decompJPEG_712x712_Q10",0.546511627906977,22,17,22,26,87
"Triceratops_manifold","Triceratops_manifold_simpL1_qp9_qt9_decompJPEG_712x712_Q75",0.172619047619047,22,17,22,26,87
"Orchid","Orchid_simpL8_qp10_qt6_decompJPEG_512x512_Q10",0.477272727272728,70,72,43,82,267
"bread_BakedUV","bread_BakedUV_simpL7_qp9_qt7_decompJPEG_1440x1440_Q75",0.523809523809525,74,52,30,54,210
"Flintlock_Pistol","Flintlock_Pistol_simpL2_qp8_qt10_decompJPEG_512x512_Q50",0.866279069767443,9,5,10,8,32
"PlaningMachine200K","PlaningMachine200K_simpL8_qp7_qt10_decompJPEG_1024x1024_Q10",0.63095238095238,60,62,67,58,247
"PRI_Hepatus","PRI_Hepatus_simpL6_qp8_qt10_decompJPEG_712x712_Q90",0.58125,57,40,52,40,189
"Orchid","Orchid_simpL9_qp11_qt7_decompJPEG_2048x2048_Q90",0.172619047619047,70,72,43,82,267
"Flintlock_Pistol","Flintlock_Pistol_simpL4_qp8_qt7_decompJPEG_2048x2048_Q75",0.84375,9,5,10,8,32
"Flintlock_Pistol","Flintlock_Pistol_simpL10_qp8_qt6_decompJPEG_712x712_Q10",0.857954545454545,9,5,10,8,32
"bread_BakedUV","bread_BakedUV_simpL5_qp7_qt6_decompJPEG_2048x2048_Q50",0.86046511627907,74,52,30,54,210
"Orchid","Orchid_simpL9_qp8_qt7_decompJPEG_2048x2048_Q90",0.232558139534883,70,72,43,82,267
"dino_retopo_uv","dino_retopo_uv_simpL3_qp9_qt8_decompJPEG_2048x2048_Q90",0.430232558139535,23,49,25,7,104
"Lidded-Ewer_bakedUV","Lidded-Ewer_bakedUV_simpL7_qp10_qt9_decompJPEG_2048x2048_Q90",0.31547619047619,61,56,66,54,237
"PRI_Hepatus","PRI_Hepatus_simpL4_qp8_qt10_decompJPEG_2048x2048_Q50",0.601190476190475,57,40,52,40,189
"Lidded-Ewer_bakedUV","Lidded-Ewer_bakedUV_simpL6_qp11_qt8_decompJPEG_1024x1024_Q75",0.238095238095237,61,56,66,54,237
"bread_BakedUV","bread_BakedUV_simpL8_qp10_qt7_decompJPEG_1440x1440_Q50",0.539772727272728,74,52,30,54,210
"shark_bakedUV","shark_bakedUV_simpL4_qp10_qt9_decompJPEG_1440x1440_Q90",0.423076923076922,22,21,15,28,86
"PRI_Hepatus","PRI_Hepatus_simpL9_qp10_qt6_decompJPEG_2048x2048_Q25",0.710227272727272,57,40,52,40,189
"Lidded-Ewer_bakedUV","Lidded-Ewer_bakedUV_simpL8_qp9_qt6_decompJPEG_2048x2048_Q90",0.791666666666668,61,56,66,54,237
"PlaningMachine200K","PlaningMachine200K_simpL9_qp10_qt7_decompJPEG_712x712_Q25",0.3625,60,62,67,58,247
"Flintlock_Pistol","Flintlock_Pistol_simpL5_qp7_qt10_decompJPEG_1440x1440_Q50",0.945121951219512,9,5,10,8,32
"dorfkirche","dorfkirche_simpL7_qp9_qt9_decompJPEG_1440x1440_Q50",0.343023255813953,70,61,73,54,258
"shark_bakedUV","shark_bakedUV_simpL10_qp9_qt6_decompJPEG_712x712_Q10",0.823863636363638,22,21,15,28,86
"dino_retopo_uv","dino_retopo_uv_simpL1_qp10_qt7_decompJPEG_1024x1024_Q25",0.482558139534882,23,49,25,7,104
"dino_retopo_uv","dino_retopo_uv_simpL1_qp10_qt8_decompJPEG_2048x2048_Q25",0.44767441860465,23,49,25,7,104
"shark_bakedUV","shark_bakedUV_simpL10_qp11_qt10_decompJPEG_2048x2048_Q90",0.595238095238095,22,21,15,28,86
"PlaningMachine200K","PlaningMachine200K_simpL9_qp8_qt6_decompJPEG_712x712_Q90",0.63953488372093,60,62,67,58,247
"dino_retopo_uv","dino_retopo_uv_simpL1_qp10_qt9_decompJPEG_2048x2048_Q10",0.14375,23,49,25,7,104
"Lidded-Ewer_bakedUV","Lidded-Ewer_bakedUV_simpL4_qp11_qt8_decompJPEG_2048x2048_Q50",0.158536585365852,61,56,66,54,237
"bread_BakedUV","bread_BakedUV_simpL7_qp7_qt7_decompJPEG_2048x2048_Q50",0.52840909090909,74,52,30,54,210
"dorfkirche","dorfkirche_simpL4_qp7_qt7_decompJPEG_712x712_Q10",0.9375,70,61,73,54,258
"dino_retopo_uv","dino_retopo_uv_simpL6_qp9_qt7_decompJPEG_1024x1024_Q10",0.5,23,49,25,7,104
"PlaningMachine200K","PlaningMachine200K_simpL10_qp8_qt10_decompJPEG_1440x1440_Q90",0.982558139534883,60,62,67,58,247
"Triceratops_manifold","Triceratops_manifold_simpL4_qp10_qt7_decompJPEG_1440x1440_Q10",0.136904761904763,22,17,22,26,87
"lizard_BakedUV","lizard_BakedUV_simpL10_qp7_qt10_decompJPEG_1024x1024_Q90",0.773255813953488,13,2,1,6,22
"Lidded-Ewer_bakedUV","Lidded-Ewer_bakedUV_simpL4_qp8_qt9_decompJPEG_1440x1440_Q90",0.583333333333332,61,56,66,54,237
"lizard_BakedUV","lizard_BakedUV_simpL10_qp7_qt8_decompJPEG_1440x1440_Q90",0.755813953488373,13,2,1,6,22
"PRI_Hepatus","PRI_Hepatus_simpL2_qp8_qt10_decompJPEG_2048x2048_Q50",0.642045454545455,57,40,52,40,189
"Orchid","Orchid_simpL9_qp10_qt7_decompJPEG_1024x1024_Q50",0.15909090909091,70,72,43,82,267
"dorfkirche","dorfkirche_simpL4_qp10_qt7_decompJPEG_1024x1024_Q50",0.625,70,61,73,54,258
"lizard_BakedUV","lizard_BakedUV_simpL6_qp10_qt6_decompJPEG_512x512_Q75",0.34090909090909,13,2,1,6,22
"Triceratops_manifold","Triceratops_manifold_simpL9_qp7_qt10_decompJPEG_1024x1024_Q50",0.567073170731707,22,17,22,26,87
"Orchid","Orchid_simpL9_qp11_qt7_decompJPEG_1024x1024_Q90",0.261904761904763,70,72,43,82,267
"Orchid","Orchid_simpL8_qp8_qt8_decompJPEG_1024x1024_Q25",0.19047619047619,70,72,43,82,267
"dino_retopo_uv","dino_retopo_uv_simpL7_qp10_qt6_decompJPEG_1024x1024_Q25",0.69375,23,49,25,7,104
"Orchid","Orchid_simpL9_qp10_qt7_decompJPEG_512x512_Q25",0.267045454545455,70,72,43,82,267
"lizard_BakedUV","lizard_BakedUV_simpL9_qp8_qt10_decompJPEG_512x512_Q25",0.545454545454545,13,2,1,6,22
"Flintlock_Pistol","Flintlock_Pistol_simpL3_qp9_qt6_decompJPEG_1440x1440_Q90",0.651162790697675,9,5,10,8,32
"bread_BakedUV","bread_BakedUV_simpL10_qp8_qt10_decompJPEG_2048x2048_Q90",0.704545454545455,74,52,30,54,210
"dino_retopo_uv","dino_retopo_uv_simpL8_qp9_qt6_decompJPEG_2048x2048_Q10",0.80232558139535,23,49,25,7,104
"Orchid","Orchid_simpL2_qp11_qt6_decompJPEG_1440x1440_Q75",0.477272727272728,70,72,43,82,267
"bread_BakedUV","bread_BakedUV_simpL2_qp8_qt7_decompJPEG_1440x1440_Q90",0.50609756097561,74,52,30,54,210
"Lidded-Ewer_bakedUV","Lidded-Ewer_bakedUV_simpL5_qp9_qt7_decompJPEG_2048x2048_Q25",0.476744186046512,61,56,66,54,237
"dorfkirche","dorfkirche_simpL2_qp10_qt9_decompJPEG_2048x2048_Q90",0.109756097560975,70,61,73,54,258
"bread_BakedUV","bread_BakedUV_simpL7_qp9_qt7_decompJPEG_1440x1440_Q90",0.52906976744186,74,52,30,54,210
"Orchid","Orchid_simpL1_qp8_qt8_decompJPEG_2048x2048_Q10",0.297619047619047,70,72,43,82,267
"PRI_Hepatus","PRI_Hepatus_simpL8_qp11_qt7_decompJPEG_512x512_Q50",0.511627906976745,57,40,52,40,189
"Lidded-Ewer_bakedUV","Lidded-Ewer_bakedUV_simpL6_qp10_qt8_decompJPEG_512x512_Q10",0.448863636363637,61,56,66,54,237
"Orchid","Orchid_simpL9_qp8_qt8_decompJPEG_512x512_Q25",0.31547619047619,70,72,43,82,267
"Triceratops_manifold","Triceratops_manifold_simpL7_qp11_qt7_decompJPEG_1024x1024_Q50",0.222222222222223,22,17,22,26,87
"bread_BakedUV","bread_BakedUV_simpL9_qp9_qt7_decompJPEG_2048x2048_Q75",0.662790697674417,74,52,30,54,210
"Lidded-Ewer_bakedUV","Lidded-Ewer_bakedUV_simpL5_qp8_qt10_decompJPEG_1440x1440_Q90",0.602272727272728,61,56,66,54,237
"PlaningMachine200K","PlaningMachine200K_simpL9_qp8_qt10_decompJPEG_1440x1440_Q90",0.422619047619047,60,62,67,58,247
"Triceratops_manifold","Triceratops_manifold_simpL9_qp7_qt10_decompJPEG_512x512_Q75",0.630681818181817,22,17,22,26,87
"Triceratops_manifold","Triceratops_manifold_simpL6_qp8_qt10_decompJPEG_1024x1024_Q75",0.494318181818183,22,17,22,26,87
"shark_bakedUV","shark_bakedUV_simpL10_qp9_qt6_decompJPEG_1024x1024_Q50",0.790697674418605,22,21,15,28,86
"shark_bakedUV","shark_bakedUV_simpL10_qp8_qt6_decompJPEG_1440x1440_Q75",0.813953488372092,22,21,15,28,86
"bread_BakedUV","bread_BakedUV_simpL5_qp10_qt10_decompJPEG_1440x1440_Q25",0.21590909090909,74,52,30,54,210
"PRI_Hepatus","PRI_Hepatus_simpL8_qp8_qt10_decompJPEG_1024x1024_Q75",0.540697674418605,57,40,52,40,189
"Orchid","Orchid_simpL1_qp8_qt9_decompJPEG_1440x1440_Q10",0.284883720930233,70,72,43,82,267
"PRI_Hepatus","PRI_Hepatus_simpL9_qp9_qt6_decompJPEG_2048x2048_Q90",0.66860465116279,57,40,52,40,189
"lizard_BakedUV","lizard_BakedUV_simpL9_qp11_qt6_decompJPEG_2048x2048_Q10",0.4875,13,2,1,6,22
"PlaningMachine200K","PlaningMachine200K_simpL7_qp9_qt6_decompJPEG_1024x1024_Q90",0.488095238095237,60,62,67,58,247
