"Model","stimulus","MOS","VP1","VP2","VP3","VP4","TotalPatches"
"yourMesh","yourMesh_simpL10_qp8_qt10_decompJPEG_1024x1024_Q50",0.375,89,69,94,89,341
"GoldenStatueModel","GoldenStatueModel_simpL7_qp8_qt10_decompJPEG_2048x2048_Q10",0.80232558139535,40,29,51,32,152
"GeorgeWashington_BakedUV","GeorgeWashington_BakedUV_simpL1_qp9_qt7_decompJPEG_712x712_Q10",0.463414634146343,70,40,63,37,210
"Graphosoma","Graphosoma_simpL9_qp9_qt6_decompJPEG_712x712_Q10",0.45625,35,34,41,33,143
"diez_BakedUV","diez_BakedUV_simpL8_qp10_qt6_decompJPEG_1440x1440_Q75",0.75,73,50,54,52,229
"Streblognathus","Streblognathus_simpL4_qp8_qt6_decompJPEG_512x512_Q75",0.818181818181817,17,13,9,17,56
"GoldenStatueModel","GoldenStatueModel_simpL1_qp9_qt6_decompJPEG_1024x1024_Q25",0.647727272727272,40,29,51,32,152
"JaneAnne_WithBase","JaneAnne_WithBase_simpL4_qp10_qt8_decompJPEG_512x512_Q75",0.645348837209302,51,37,37,41,166
"skiboot_BakedUV","skiboot_BakedUV_simpL9_qp7_qt6_decompJPEG_1440x1440_Q90",0.975,90,71,102,102,365
"Boiler","Boiler_simpL5_qp7_qt10_decompJPEG_1440x1440_Q75",0.839285714285715,51,51,57,51,210
"Orbiter_Space_Shuttle_OV-103_Discovery-150k-4096","Orbiter_Space_Shuttle_OV-103_Discovery-150k-4096_simpL9_qp9_qt6_decompJPEG_1024x1024_Q10",0.914772727272728,32,24,37,9,102
"AsparnLoewe_C","AsparnLoewe_C_simpL1_qp9_qt10_decompJPEG_512x512_Q75",0.65340909090909,149,137,146,140,572
"diez_BakedUV","diez_BakedUV_simpL4_qp10_qt7_decompJPEG_1024x1024_Q50",0.511904761904763,73,50,54,52,229
"JaneAnne_WithBase","JaneAnne_WithBase_simpL9_qp10_qt6_decompJPEG_512x512_Q90",0.794444444444445,51,37,37,41,166
"JaneAnne_WithBase","JaneAnne_WithBase_simpL2_qp9_qt9_decompJPEG_712x712_Q75",0.59375,51,37,37,41,166
"yourMesh","yourMesh_simpL4_qp7_qt10_decompJPEG_2048x2048_Q75",0.773255813953488,89,69,94,89,341
"yourMesh","yourMesh_simpL10_qp7_qt7_decompJPEG_2048x2048_Q50",0.383720930232557,89,69,94,89,341
"JaneAnne_WithBase","JaneAnne_WithBase_simpL1_qp8_qt10_decompJPEG_712x712_Q25",0.744318181818183,51,37,37,41,166
"diez_BakedUV","diez_BakedUV_simpL5_qp10_qt7_decompJPEG_712x712_Q25",0.44767441860465,73,50,54,52,229
"Boiler","Boiler_simpL8_qp7_qt10_decompJPEG_712x712_Q90",0.773809523809525,51,51,57,51,210
"diez_BakedUV","diez_BakedUV_simpL9_qp11_qt10_decompJPEG_512x512_Q50",0.1125,73,50,54,52,229
"Streblognathus","Streblognathus_simpL2_qp8_qt6_decompJPEG_1440x1440_Q10",0.84090909090909,17,13,9,17,56
"yourMesh","yourMesh_simpL10_qp11_qt9_decompJPEG_1440x1440_Q75",0.343023255813953,89,69,94,89,341
"yourMesh","yourMesh_simpL6_qp8_qt10_decompJPEG_1440x1440_Q90",0.44047619047619,89,69,94,89,341
"JaneAnne_WithBase","JaneAnne_WithBase_simpL9_qp8_qt6_decompJPEG_512x512_Q75",0.857142857142857,51,37,37,41,166
"JaneAnne_WithBase","JaneAnne_WithBase_simpL9_qp8_qt6_decompJPEG_2048x2048_Q10",0.9125,51,37,37,41,166
"Orbiter_Space_Shuttle_OV-103_Discovery-150k-4096","Orbiter_Space_Shuttle_OV-103_Discovery-150k-4096_simpL5_qp11_qt9_decompJPEG_512x512_Q25",0.61875,32,24,37,9,102
"Streblognathus","Streblognathus_simpL8_qp7_qt10_decompJPEG_512x512_Q75",0.976744186046512,17,13,9,17,56
"JaneAnne_WithBase","JaneAnne_WithBase_simpL1_qp10_qt7_decompJPEG_512x512_Q90",0.703488372093023,51,37,37,41,166
"GeorgeWashington_BakedUV","GeorgeWashington_BakedUV_simpL8_qp11_qt9_decompJPEG_2048x2048_Q90",0.3625,70,40,63,37,210
"GoldenStatueModel","GoldenStatueModel_simpL5_qp9_qt10_decompJPEG_712x712_Q10",0.636904761904763,40,29,51,32,152
"Orbiter_Space_Shuttle_OV-103_Discovery-150k-4096","Orbiter_Space_Shuttle_OV-103_Discovery-150k-4096_simpL1_qp10_qt8_decompJPEG_712x712_Q90",0.607954545454545,32,24,37,9,102
"Streblognathus","Streblognathus_simpL3_qp7_qt6_decompJPEG_2048x2048_Q10",0.988636363636362,17,13,9,17,56
"yourMesh","yourMesh_simpL1_qp11_qt7_decompJPEG_1440x1440_Q75",0.619318181818183,89,69,94,89,341
"diez_BakedUV","diez_BakedUV_simpL4_qp11_qt7_decompJPEG_1440x1440_Q10",0.505681818181817,73,50,54,52,229
"yourMesh","yourMesh_simpL10_qp8_qt7_decompJPEG_1440x1440_Q10",0.488636363636363,89,69,94,89,341
"Graphosoma","Graphosoma_simpL9_qp11_qt6_decompJPEG_512x512_Q90",0.383333333333333,35,34,41,33,143
"diez_BakedUV","diez_BakedUV_simpL10_qp10_qt9_decompJPEG_2048x2048_Q90",0.744318181818183,73,50,54,52,229
"diez_BakedUV","diez_BakedUV_simpL8_qp11_qt6_decompJPEG_2048x2048_Q90",0.86904761904762,73,50,54,52,229
"Streblognathus","Streblognathus_simpL2_qp9_qt6_decompJPEG_2048x2048_Q75",0.56578947368421,17,13,9,17,56
"GeorgeWashington_BakedUV","GeorgeWashington_BakedUV_simpL7_qp10_qt9_decompJPEG_512x512_Q10",0.431818181818183,70,40,63,37,210
"Boiler","Boiler_simpL10_qp9_qt6_decompJPEG_512x512_Q50",0.825581395348838,51,51,57,51,210
"diez_BakedUV","diez_BakedUV_simpL8_qp10_qt6_decompJPEG_712x712_Q90",0.744318181818183,73,50,54,52,229
"GoldenStatueModel","GoldenStatueModel_simpL3_qp9_qt10_decompJPEG_1440x1440_Q25",0.6875,40,29,51,32,152
"GoldenStatueModel","GoldenStatueModel_simpL1_qp9_qt10_decompJPEG_512x512_Q10",0.698863636363637,40,29,51,32,152
"Orbiter_Space_Shuttle_OV-103_Discovery-150k-4096","Orbiter_Space_Shuttle_OV-103_Discovery-150k-4096_simpL2_qp11_qt10_decompJPEG_712x712_Q50",0.202380952380953,32,24,37,9,102
"Boiler","Boiler_simpL10_qp10_qt10_decompJPEG_512x512_Q25",0.761363636363638,51,51,57,51,210
"Orbiter_Space_Shuttle_OV-103_Discovery-150k-4096","Orbiter_Space_Shuttle_OV-103_Discovery-150k-4096_simpL9_qp10_qt10_decompJPEG_712x712_Q25",0.81547619047619,32,24,37,9,102
"AsparnLoewe_C","AsparnLoewe_C_simpL8_qp10_qt9_decompJPEG_712x712_Q25",0.321428571428573,149,137,146,140,572
"yourMesh","yourMesh_simpL3_qp11_qt8_decompJPEG_512x512_Q50",0.171052631578948,89,69,94,89,341
"Orbiter_Space_Shuttle_OV-103_Discovery-150k-4096","Orbiter_Space_Shuttle_OV-103_Discovery-150k-4096_simpL4_qp11_qt10_decompJPEG_512x512_Q50",0.35625,32,24,37,9,102
"Graphosoma","Graphosoma_simpL3_qp8_qt10_decompJPEG_2048x2048_Q75",0.556818181818183,35,34,41,33,143
"AsparnLoewe_C","AsparnLoewe_C_simpL3_qp9_qt7_decompJPEG_1024x1024_Q25",0.829545454545455,149,137,146,140,572
"JaneAnne_WithBase","JaneAnne_WithBase_simpL1_qp10_qt7_decompJPEG_512x512_Q50",0.72093023255814,51,37,37,41,166
"JaneAnne_WithBase","JaneAnne_WithBase_simpL9_qp10_qt6_decompJPEG_512x512_Q75",0.77840909090909,51,37,37,41,166
"GeorgeWashington_BakedUV","GeorgeWashington_BakedUV_simpL7_qp11_qt6_decompJPEG_512x512_Q50",0.680232558139535,70,40,63,37,210
"Orbiter_Space_Shuttle_OV-103_Discovery-150k-4096","Orbiter_Space_Shuttle_OV-103_Discovery-150k-4096_simpL4_qp9_qt8_decompJPEG_512x512_Q25",0.689024390243902,32,24,37,9,102
"Graphosoma","Graphosoma_simpL5_qp11_qt7_decompJPEG_2048x2048_Q90",0.28409090909091,35,34,41,33,143
"GeorgeWashington_BakedUV","GeorgeWashington_BakedUV_simpL2_qp9_qt7_decompJPEG_712x712_Q25",0.428571428571427,70,40,63,37,210
"GeorgeWashington_BakedUV","GeorgeWashington_BakedUV_simpL3_qp9_qt10_decompJPEG_1024x1024_Q10",0.431818181818183,70,40,63,37,210
"AsparnLoewe_C","AsparnLoewe_C_simpL1_qp9_qt9_decompJPEG_712x712_Q25",0.630681818181817,149,137,146,140,572
"Graphosoma","Graphosoma_simpL7_qp8_qt6_decompJPEG_1024x1024_Q25",0.616279069767443,35,34,41,33,143
"yourMesh","yourMesh_simpL10_qp7_qt8_decompJPEG_1440x1440_Q25",0.424418604651163,89,69,94,89,341
"diez_BakedUV","diez_BakedUV_simpL4_qp9_qt10_decompJPEG_512x512_Q25",0.365853658536585,73,50,54,52,229
"GeorgeWashington_BakedUV","GeorgeWashington_BakedUV_simpL7_qp11_qt6_decompJPEG_712x712_Q25",0.72093023255814,70,40,63,37,210
"Graphosoma","Graphosoma_simpL3_qp8_qt10_decompJPEG_512x512_Q90",0.583333333333332,35,34,41,33,143
"yourMesh","yourMesh_simpL4_qp11_qt8_decompJPEG_712x712_Q10",0.31547619047619,89,69,94,89,341
"Streblognathus","Streblognathus_simpL2_qp11_qt6_decompJPEG_1024x1024_Q25",0.569767441860465,17,13,9,17,56
"Streblognathus","Streblognathus_simpL4_qp7_qt6_decompJPEG_2048x2048_Q75",0.97560975609756,17,13,9,17,56
"Boiler","Boiler_simpL8_qp7_qt9_decompJPEG_1024x1024_Q90",0.8125,51,51,57,51,210
"Graphosoma","Graphosoma_simpL9_qp7_qt6_decompJPEG_1440x1440_Q10",0.76923076923077,35,34,41,33,143
"yourMesh","yourMesh_simpL10_qp7_qt7_decompJPEG_2048x2048_Q90",0.458333333333332,89,69,94,89,341
"diez_BakedUV","diez_BakedUV_simpL1_qp10_qt8_decompJPEG_2048x2048_Q10",0.327380952380953,73,50,54,52,229
"diez_BakedUV","diez_BakedUV_simpL9_qp10_qt7_decompJPEG_712x712_Q25",0.436046511627908,73,50,54,52,229
"diez_BakedUV","diez_BakedUV_simpL9_qp11_qt9_decompJPEG_512x512_Q50",0.142857142857143,73,50,54,52,229
"diez_BakedUV","diez_BakedUV_simpL3_qp9_qt10_decompJPEG_1440x1440_Q25",0.38125,73,50,54,52,229
"Streblognathus","Streblognathus_simpL8_qp8_qt8_decompJPEG_2048x2048_Q10",0.694444444444445,17,13,9,17,56
"Boiler","Boiler_simpL1_qp9_qt9_decompJPEG_1440x1440_Q25",0.459302325581395,51,51,57,51,210
"GoldenStatueModel","GoldenStatueModel_simpL6_qp9_qt6_decompJPEG_1440x1440_Q25",0.621794871794872,40,29,51,32,152
"Graphosoma","Graphosoma_simpL6_qp7_qt6_decompJPEG_2048x2048_Q25",0.924418604651162,35,34,41,33,143
"skiboot_BakedUV","skiboot_BakedUV_simpL3_qp9_qt6_decompJPEG_1024x1024_Q75",0.77439024390244,90,71,102,102,365
"yourMesh","yourMesh_simpL3_qp7_qt6_decompJPEG_512x512_Q25",0.8625,89,69,94,89,341
"Graphosoma","Graphosoma_simpL10_qp11_qt7_decompJPEG_1024x1024_Q50",0.209302325581395,35,34,41,33,143
"AsparnLoewe_C","AsparnLoewe_C_simpL7_qp11_qt10_decompJPEG_512x512_Q75",0.232558139534883,149,137,146,140,572
"Graphosoma","Graphosoma_simpL10_qp9_qt6_decompJPEG_512x512_Q50",0.25,35,34,41,33,143
"Graphosoma","Graphosoma_simpL10_qp9_qt7_decompJPEG_1024x1024_Q90",0.267045454545455,35,34,41,33,143
"Orbiter_Space_Shuttle_OV-103_Discovery-150k-4096","Orbiter_Space_Shuttle_OV-103_Discovery-150k-4096_simpL8_qp11_qt9_decompJPEG_712x712_Q10",0.74375,32,24,37,9,102
"AsparnLoewe_C","AsparnLoewe_C_simpL5_qp11_qt7_decompJPEG_2048x2048_Q75",0.68125,149,137,146,140,572
"Streblognathus","Streblognathus_simpL6_qp10_qt7_decompJPEG_2048x2048_Q25",0.226190476190478,17,13,9,17,56
"skiboot_BakedUV","skiboot_BakedUV_simpL3_qp9_qt6_decompJPEG_2048x2048_Q75",0.791666666666668,90,71,102,102,365
"GoldenStatueModel","GoldenStatueModel_simpL9_qp7_qt9_decompJPEG_512x512_Q10",0.982142857142857,40,29,51,32,152
"yourMesh","yourMesh_simpL2_qp10_qt8_decompJPEG_512x512_Q25",0.25,89,69,94,89,341
"GoldenStatueModel","GoldenStatueModel_simpL9_qp7_qt6_decompJPEG_1440x1440_Q25",0.965116279069767,40,29,51,32,152
"GeorgeWashington_BakedUV","GeorgeWashington_BakedUV_simpL9_qp8_qt7_decompJPEG_1024x1024_Q10",0.73780487804878,70,40,63,37,210
"diez_BakedUV","diez_BakedUV_simpL3_qp11_qt6_decompJPEG_2048x2048_Q75",0.848837209302325,73,50,54,52,229
"yourMesh","yourMesh_simpL10_qp7_qt7_decompJPEG_1024x1024_Q25",0.517045454545455,89,69,94,89,341
"Graphosoma","Graphosoma_simpL9_qp8_qt6_decompJPEG_1440x1440_Q50",0.53048780487805,35,34,41,33,143
"GeorgeWashington_BakedUV","GeorgeWashington_BakedUV_simpL7_qp9_qt6_decompJPEG_512x512_Q10",0.784883720930233,70,40,63,37,210
"JaneAnne_WithBase","JaneAnne_WithBase_simpL9_qp11_qt10_decompJPEG_512x512_Q75",0.323863636363637,51,37,37,41,166
"Graphosoma","Graphosoma_simpL7_qp8_qt10_decompJPEG_1440x1440_Q50",0.470238095238095,35,34,41,33,143
"Orbiter_Space_Shuttle_OV-103_Discovery-150k-4096","Orbiter_Space_Shuttle_OV-103_Discovery-150k-4096_simpL9_qp11_qt6_decompJPEG_1440x1440_Q75",0.948863636363638,32,24,37,9,102
"diez_BakedUV","diez_BakedUV_simpL9_qp9_qt9_decompJPEG_512x512_Q50",0.273255813953488,73,50,54,52,229
"Graphosoma","Graphosoma_simpL9_qp9_qt6_decompJPEG_2048x2048_Q10",0.401162790697675,35,34,41,33,143
"skiboot_BakedUV","skiboot_BakedUV_simpL5_qp8_qt9_decompJPEG_512x512_Q75",0.616279069767443,90,71,102,102,365
"JaneAnne_WithBase","JaneAnne_WithBase_simpL7_qp11_qt9_decompJPEG_1024x1024_Q10",0.50595238095238,51,37,37,41,166
"skiboot_BakedUV","skiboot_BakedUV_simpL3_qp9_qt6_decompJPEG_2048x2048_Q90",0.786585365853657,90,71,102,102,365
"GeorgeWashington_BakedUV","GeorgeWashington_BakedUV_simpL7_qp10_qt6_decompJPEG_512x512_Q10",0.784883720930233,70,40,63,37,210
"GeorgeWashington_BakedUV","GeorgeWashington_BakedUV_simpL9_qp8_qt10_decompJPEG_2048x2048_Q50",0.71875,70,40,63,37,210
"diez_BakedUV","diez_BakedUV_simpL9_qp10_qt7_decompJPEG_512x512_Q10",0.505813953488373,73,50,54,52,229
"skiboot_BakedUV","skiboot_BakedUV_simpL2_qp9_qt10_decompJPEG_1024x1024_Q90",0.27906976744186,90,71,102,102,365
"GeorgeWashington_BakedUV","GeorgeWashington_BakedUV_simpL7_qp11_qt6_decompJPEG_712x712_Q10",0.80813953488372,70,40,63,37,210
"skiboot_BakedUV","skiboot_BakedUV_simpL2_qp11_qt6_decompJPEG_512x512_Q90",0.744318181818183,90,71,102,102,365
"yourMesh","yourMesh_simpL10_qp11_qt10_decompJPEG_2048x2048_Q25",0.386904761904763,89,69,94,89,341
"JaneAnne_WithBase","JaneAnne_WithBase_simpL3_qp8_qt10_decompJPEG_512x512_Q25",0.6625,51,37,37,41,166
"Orbiter_Space_Shuttle_OV-103_Discovery-150k-4096","Orbiter_Space_Shuttle_OV-103_Discovery-150k-4096_simpL2_qp8_qt8_decompJPEG_1024x1024_Q10",0.866279069767443,32,24,37,9,102
"GoldenStatueModel","GoldenStatueModel_simpL6_qp7_qt10_decompJPEG_712x712_Q10",0.96111111111111,40,29,51,32,152
"GoldenStatueModel","GoldenStatueModel_simpL2_qp9_qt6_decompJPEG_2048x2048_Q90",0.613636363636363,40,29,51,32,152
"diez_BakedUV","diez_BakedUV_simpL10_qp7_qt8_decompJPEG_512x512_Q90",0.85,73,50,54,52,229
"Boiler","Boiler_simpL9_qp10_qt7_decompJPEG_2048x2048_Q25",0.428571428571427,51,51,57,51,210
"Graphosoma","Graphosoma_simpL10_qp9_qt6_decompJPEG_1440x1440_Q25",0.267441860465118,35,34,41,33,143
"Boiler","Boiler_simpL1_qp11_qt6_decompJPEG_1024x1024_Q10",0.482558139534882,51,51,57,51,210
"GoldenStatueModel","GoldenStatueModel_simpL9_qp7_qt10_decompJPEG_512x512_Q10",0.966666666666667,40,29,51,32,152
"Graphosoma","Graphosoma_simpL7_qp8_qt9_decompJPEG_1024x1024_Q90",0.482954545454545,35,34,41,33,143
"diez_BakedUV","diez_BakedUV_simpL10_qp8_qt7_decompJPEG_1024x1024_Q50",0.73888888888889,73,50,54,52,229
"Graphosoma","Graphosoma_simpL9_qp11_qt6_decompJPEG_2048x2048_Q75",0.3875,35,34,41,33,143
"Boiler","Boiler_simpL4_qp9_qt9_decompJPEG_512x512_Q25",0.443181818181817,51,51,57,51,210
"GeorgeWashington_BakedUV","GeorgeWashington_BakedUV_simpL2_qp9_qt7_decompJPEG_1440x1440_Q10",0.452380952380953,70,40,63,37,210
"GeorgeWashington_BakedUV","GeorgeWashington_BakedUV_simpL9_qp8_qt7_decompJPEG_2048x2048_Q25",0.738095238095237,70,40,63,37,210
"AsparnLoewe_C","AsparnLoewe_C_simpL2_qp9_qt9_decompJPEG_1440x1440_Q10",0.68452380952381,149,137,146,140,572
"yourMesh","yourMesh_simpL1_qp8_qt8_decompJPEG_512x512_Q75",0.482558139534882,89,69,94,89,341
"JaneAnne_WithBase","JaneAnne_WithBase_simpL9_qp10_qt6_decompJPEG_512x512_Q10",0.875,51,37,37,41,166
"GeorgeWashington_BakedUV","GeorgeWashington_BakedUV_simpL7_qp11_qt6_decompJPEG_512x512_Q75",0.72159090909091,70,40,63,37,210
"GeorgeWashington_BakedUV","GeorgeWashington_BakedUV_simpL9_qp11_qt10_decompJPEG_1440x1440_Q75",0.573863636363637,70,40,63,37,210
"AsparnLoewe_C","AsparnLoewe_C_simpL1_qp10_qt8_decompJPEG_712x712_Q75",0.539772727272728,149,137,146,140,572
"Graphosoma","Graphosoma_simpL3_qp8_qt10_decompJPEG_712x712_Q90",0.522727272727272,35,34,41,33,143
"Boiler","Boiler_simpL10_qp8_qt7_decompJPEG_712x712_Q50",0.744444444444445,51,51,57,51,210
"AsparnLoewe_C","AsparnLoewe_C_simpL8_qp8_qt10_decompJPEG_512x512_Q25",0.857142857142857,149,137,146,140,572
"Orbiter_Space_Shuttle_OV-103_Discovery-150k-4096","Orbiter_Space_Shuttle_OV-103_Discovery-150k-4096_simpL2_qp9_qt8_decompJPEG_712x712_Q50",0.701219512195122,32,24,37,9,102
"AsparnLoewe_C","AsparnLoewe_C_simpL4_qp11_qt8_decompJPEG_712x712_Q10",0.505681818181817,149,137,146,140,572
"Boiler","Boiler_simpL8_qp9_qt10_decompJPEG_512x512_Q90",0.375,51,51,57,51,210
"AsparnLoewe_C","AsparnLoewe_C_simpL3_qp10_qt10_decompJPEG_1024x1024_Q10",0.460227272727272,149,137,146,140,572
"GoldenStatueModel","GoldenStatueModel_simpL6_qp8_qt7_decompJPEG_512x512_Q10",0.83139534883721,40,29,51,32,152
"AsparnLoewe_C","AsparnLoewe_C_simpL3_qp10_qt9_decompJPEG_512x512_Q25",0.377906976744185,149,137,146,140,572
"GeorgeWashington_BakedUV","GeorgeWashington_BakedUV_simpL2_qp9_qt7_decompJPEG_1024x1024_Q10",0.47093023255814,70,40,63,37,210
"Orbiter_Space_Shuttle_OV-103_Discovery-150k-4096","Orbiter_Space_Shuttle_OV-103_Discovery-150k-4096_simpL9_qp11_qt6_decompJPEG_2048x2048_Q50",0.9375,32,24,37,9,102
"skiboot_BakedUV","skiboot_BakedUV_simpL3_qp8_qt6_decompJPEG_1440x1440_Q25",0.86046511627907,90,71,102,102,365
"GoldenStatueModel","GoldenStatueModel_simpL7_qp9_qt9_decompJPEG_512x512_Q10",0.534883720930233,40,29,51,32,152
"Graphosoma","Graphosoma_simpL8_qp10_qt6_decompJPEG_2048x2048_Q75",0.448863636363637,35,34,41,33,143
"Boiler","Boiler_simpL8_qp7_qt7_decompJPEG_712x712_Q25",0.823863636363638,51,51,57,51,210
"Streblognathus","Streblognathus_simpL8_qp11_qt8_decompJPEG_512x512_Q75",0.105555555555555,17,13,9,17,56
"Boiler","Boiler_simpL8_qp11_qt6_decompJPEG_512x512_Q75",0.517857142857142,51,51,57,51,210
"diez_BakedUV","diez_BakedUV_simpL5_qp11_qt6_decompJPEG_2048x2048_Q90",0.77906976744186,73,50,54,52,229
"JaneAnne_WithBase","JaneAnne_WithBase_simpL9_qp11_qt6_decompJPEG_512x512_Q90",0.772222222222222,51,37,37,41,166
"GeorgeWashington_BakedUV","GeorgeWashington_BakedUV_simpL5_qp8_qt10_decompJPEG_1024x1024_Q10",0.69375,70,40,63,37,210
"yourMesh","yourMesh_simpL1_qp7_qt9_decompJPEG_1024x1024_Q25",0.90340909090909,89,69,94,89,341
"skiboot_BakedUV","skiboot_BakedUV_simpL3_qp9_qt6_decompJPEG_512x512_Q75",0.738372093023255,90,71,102,102,365
"Streblognathus","Streblognathus_simpL10_qp7_qt6_decompJPEG_2048x2048_Q25",0.424418604651163,17,13,9,17,56
"Boiler","Boiler_simpL4_qp9_qt7_decompJPEG_1440x1440_Q50",0.5,51,51,57,51,210
"Orbiter_Space_Shuttle_OV-103_Discovery-150k-4096","Orbiter_Space_Shuttle_OV-103_Discovery-150k-4096_simpL9_qp11_qt6_decompJPEG_1440x1440_Q25",0.910714285714285,32,24,37,9,102
"JaneAnne_WithBase","JaneAnne_WithBase_simpL1_qp11_qt7_decompJPEG_512x512_Q90",0.681818181818183,51,37,37,41,166
"Boiler","Boiler_simpL6_qp7_qt8_decompJPEG_712x712_Q10",0.877777777777778,51,51,57,51,210
"skiboot_BakedUV","skiboot_BakedUV_simpL4_qp11_qt6_decompJPEG_512x512_Q75",0.707317073170732,90,71,102,102,365
"Boiler","Boiler_simpL8_qp11_qt6_decompJPEG_512x512_Q10",0.568181818181817,51,51,57,51,210
"Boiler","Boiler_simpL4_qp9_qt9_decompJPEG_1024x1024_Q25",0.41111111111111,51,51,57,51,210
"diez_BakedUV","diez_BakedUV_simpL8_qp11_qt10_decompJPEG_512x512_Q50",0.11046511627907,73,50,54,52,229
"Orbiter_Space_Shuttle_OV-103_Discovery-150k-4096","Orbiter_Space_Shuttle_OV-103_Discovery-150k-4096_simpL8_qp8_qt9_decompJPEG_712x712_Q50",0.83139534883721,32,24,37,9,102
"GeorgeWashington_BakedUV","GeorgeWashington_BakedUV_simpL7_qp11_qt10_decompJPEG_512x512_Q10",0.488095238095237,70,40,63,37,210
"AsparnLoewe_C","AsparnLoewe_C_simpL2_qp7_qt8_decompJPEG_512x512_Q10",0.988372093023255,149,137,146,140,572
"yourMesh","yourMesh_simpL9_qp7_qt10_decompJPEG_1024x1024_Q10",0.647435897435897,89,69,94,89,341
"diez_BakedUV","diez_BakedUV_simpL9_qp10_qt9_decompJPEG_712x712_Q50",0.119318181818183,73,50,54,52,229
"skiboot_BakedUV","skiboot_BakedUV_simpL9_qp7_qt6_decompJPEG_1440x1440_Q50",0.948863636363638,90,71,102,102,365
"Graphosoma","Graphosoma_simpL6_qp11_qt6_decompJPEG_712x712_Q50",0.425,35,34,41,33,143
"Streblognathus","Streblognathus_simpL8_qp7_qt7_decompJPEG_512x512_Q50",0.952380952380953,17,13,9,17,56
"GeorgeWashington_BakedUV","GeorgeWashington_BakedUV_simpL1_qp11_qt6_decompJPEG_2048x2048_Q25",0.708333333333332,70,40,63,37,210
"AsparnLoewe_C","AsparnLoewe_C_simpL1_qp9_qt10_decompJPEG_512x512_Q90",0.58125,149,137,146,140,572
"GoldenStatueModel","GoldenStatueModel_simpL2_qp11_qt6_decompJPEG_1440x1440_Q75",0.363095238095237,40,29,51,32,152
"yourMesh","yourMesh_simpL2_qp10_qt9_decompJPEG_712x712_Q90",0.102272727272728,89,69,94,89,341
"skiboot_BakedUV","skiboot_BakedUV_simpL6_qp10_qt10_decompJPEG_1024x1024_Q90",0.128048780487805,90,71,102,102,365
"GeorgeWashington_BakedUV","GeorgeWashington_BakedUV_simpL4_qp8_qt8_decompJPEG_1024x1024_Q25",0.701219512195122,70,40,63,37,210
"yourMesh","yourMesh_simpL1_qp10_qt8_decompJPEG_712x712_Q75",0.23125,89,69,94,89,341
"GeorgeWashington_BakedUV","GeorgeWashington_BakedUV_simpL4_qp10_qt6_decompJPEG_512x512_Q25",0.666666666666668,70,40,63,37,210
"GeorgeWashington_BakedUV","GeorgeWashington_BakedUV_simpL7_qp11_qt7_decompJPEG_1024x1024_Q10",0.395348837209302,70,40,63,37,210
"GoldenStatueModel","GoldenStatueModel_simpL2_qp9_qt6_decompJPEG_1024x1024_Q50",0.678571428571427,40,29,51,32,152
"Graphosoma","Graphosoma_simpL5_qp10_qt6_decompJPEG_2048x2048_Q50",0.55921052631579,35,34,41,33,143
"GoldenStatueModel","GoldenStatueModel_simpL6_qp8_qt10_decompJPEG_2048x2048_Q10",0.872093023255815,40,29,51,32,152
"GeorgeWashington_BakedUV","GeorgeWashington_BakedUV_simpL2_qp11_qt6_decompJPEG_2048x2048_Q75",0.672222222222222,70,40,63,37,210
"AsparnLoewe_C","AsparnLoewe_C_simpL6_qp8_qt7_decompJPEG_712x712_Q50",0.945121951219512,149,137,146,140,572
"GoldenStatueModel","GoldenStatueModel_simpL9_qp7_qt10_decompJPEG_712x712_Q25",0.930232558139535,40,29,51,32,152
"JaneAnne_WithBase","JaneAnne_WithBase_simpL1_qp8_qt10_decompJPEG_512x512_Q90",0.65909090909091,51,37,37,41,166
"yourMesh","yourMesh_simpL10_qp10_qt10_decompJPEG_2048x2048_Q90",0.289772727272728,89,69,94,89,341
"JaneAnne_WithBase","JaneAnne_WithBase_simpL3_qp11_qt9_decompJPEG_512x512_Q50",0.523255813953488,51,37,37,41,166
"GeorgeWashington_BakedUV","GeorgeWashington_BakedUV_simpL7_qp9_qt6_decompJPEG_512x512_Q25",0.827380952380953,70,40,63,37,210
"yourMesh","yourMesh_simpL4_qp9_qt8_decompJPEG_712x712_Q10",0.397435897435897,89,69,94,89,341
"Orbiter_Space_Shuttle_OV-103_Discovery-150k-4096","Orbiter_Space_Shuttle_OV-103_Discovery-150k-4096_simpL9_qp9_qt6_decompJPEG_1440x1440_Q50",0.906976744186047,32,24,37,9,102
"skiboot_BakedUV","skiboot_BakedUV_simpL1_qp8_qt10_decompJPEG_1440x1440_Q25",0.593023255813953,90,71,102,102,365
"Orbiter_Space_Shuttle_OV-103_Discovery-150k-4096","Orbiter_Space_Shuttle_OV-103_Discovery-150k-4096_simpL6_qp9_qt8_decompJPEG_712x712_Q75",0.664634146341462,32,24,37,9,102
"diez_BakedUV","diez_BakedUV_simpL10_qp7_qt7_decompJPEG_2048x2048_Q90",0.839285714285715,73,50,54,52,229
"yourMesh","yourMesh_simpL7_qp9_qt7_decompJPEG_1024x1024_Q10",0.573863636363637,89,69,94,89,341
"Orbiter_Space_Shuttle_OV-103_Discovery-150k-4096","Orbiter_Space_Shuttle_OV-103_Discovery-150k-4096_simpL8_qp9_qt9_decompJPEG_1440x1440_Q75",0.74375,32,24,37,9,102
"AsparnLoewe_C","AsparnLoewe_C_simpL5_qp8_qt10_decompJPEG_2048x2048_Q50",0.958333333333332,149,137,146,140,572
"Streblognathus","Streblognathus_simpL1_qp7_qt6_decompJPEG_2048x2048_Q10",0.99375,17,13,9,17,56
"JaneAnne_WithBase","JaneAnne_WithBase_simpL9_qp8_qt6_decompJPEG_2048x2048_Q75",0.875,51,37,37,41,166
"GoldenStatueModel","GoldenStatueModel_simpL9_qp7_qt6_decompJPEG_712x712_Q10",0.96111111111111,40,29,51,32,152
"yourMesh","yourMesh_simpL10_qp10_qt8_decompJPEG_1440x1440_Q25",0.363095238095237,89,69,94,89,341
"Streblognathus","Streblognathus_simpL8_qp7_qt6_decompJPEG_2048x2048_Q50",0.982954545454545,17,13,9,17,56
"AsparnLoewe_C","AsparnLoewe_C_simpL5_qp11_qt8_decompJPEG_2048x2048_Q75",0.422222222222222,149,137,146,140,572
"yourMesh","yourMesh_simpL10_qp9_qt7_decompJPEG_1440x1440_Q10",0.40909090909091,89,69,94,89,341
"yourMesh","yourMesh_simpL10_qp10_qt7_decompJPEG_1024x1024_Q90",0.427777777777777,89,69,94,89,341
"diez_BakedUV","diez_BakedUV_simpL2_qp9_qt7_decompJPEG_1024x1024_Q90",0.58139534883721,73,50,54,52,229
"skiboot_BakedUV","skiboot_BakedUV_simpL4_qp10_qt8_decompJPEG_1024x1024_Q75",0.40909090909091,90,71,102,102,365
"Graphosoma","Graphosoma_simpL5_qp8_qt6_decompJPEG_512x512_Q50",0.69767441860465,35,34,41,33,143
"JaneAnne_WithBase","JaneAnne_WithBase_simpL9_qp7_qt6_decompJPEG_712x712_Q25",0.959302325581395,51,37,37,41,166
"Orbiter_Space_Shuttle_OV-103_Discovery-150k-4096","Orbiter_Space_Shuttle_OV-103_Discovery-150k-4096_simpL9_qp11_qt6_decompJPEG_712x712_Q75",0.920454545454545,32,24,37,9,102
"Streblognathus","Streblognathus_simpL10_qp9_qt6_decompJPEG_1440x1440_Q10",0.319767441860465,17,13,9,17,56
"diez_BakedUV","diez_BakedUV_simpL10_qp11_qt7_decompJPEG_712x712_Q50",0.761363636363638,73,50,54,52,229
"GeorgeWashington_BakedUV","GeorgeWashington_BakedUV_simpL6_qp8_qt7_decompJPEG_1440x1440_Q10",0.689024390243902,70,40,63,37,210
"Orbiter_Space_Shuttle_OV-103_Discovery-150k-4096","Orbiter_Space_Shuttle_OV-103_Discovery-150k-4096_simpL9_qp11_qt6_decompJPEG_712x712_Q90",0.922619047619047,32,24,37,9,102
"Boiler","Boiler_simpL10_qp8_qt6_decompJPEG_1440x1440_Q25",0.7625,51,51,57,51,210
"AsparnLoewe_C","AsparnLoewe_C_simpL8_qp8_qt10_decompJPEG_512x512_Q10",0.910714285714285,149,137,146,140,572
"GoldenStatueModel","GoldenStatueModel_simpL9_qp7_qt6_decompJPEG_1440x1440_Q10",0.96590909090909,40,29,51,32,152
"yourMesh","yourMesh_simpL2_qp11_qt8_decompJPEG_2048x2048_Q50",0.207317073170733,89,69,94,89,341
"GoldenStatueModel","GoldenStatueModel_simpL6_qp9_qt6_decompJPEG_712x712_Q10",0.613095238095237,40,29,51,32,152
"GeorgeWashington_BakedUV","GeorgeWashington_BakedUV_simpL2_qp11_qt6_decompJPEG_1024x1024_Q90",0.773809523809525,70,40,63,37,210
"GeorgeWashington_BakedUV","GeorgeWashington_BakedUV_simpL7_qp8_qt8_decompJPEG_2048x2048_Q10",0.698863636363637,70,40,63,37,210
"JaneAnne_WithBase","JaneAnne_WithBase_simpL2_qp11_qt10_decompJPEG_712x712_Q25",0.203488372093023,51,37,37,41,166
"skiboot_BakedUV","skiboot_BakedUV_simpL4_qp9_qt6_decompJPEG_512x512_Q90",0.74404761904762,90,71,102,102,365
"Streblognathus","Streblognathus_simpL8_qp7_qt7_decompJPEG_2048x2048_Q90",0.953488372093023,17,13,9,17,56
"Graphosoma","Graphosoma_simpL1_qp7_qt6_decompJPEG_2048x2048_Q10",0.91111111111111,35,34,41,33,143
"Streblognathus","Streblognathus_simpL9_qp7_qt6_decompJPEG_512x512_Q50",0.892045454545455,17,13,9,17,56
"GeorgeWashington_BakedUV","GeorgeWashington_BakedUV_simpL7_qp8_qt10_decompJPEG_1440x1440_Q10",0.681818181818183,70,40,63,37,210
"Orbiter_Space_Shuttle_OV-103_Discovery-150k-4096","Orbiter_Space_Shuttle_OV-103_Discovery-150k-4096_simpL4_qp10_qt9_decompJPEG_2048x2048_Q75",0.40340909090909,32,24,37,9,102
"yourMesh","yourMesh_simpL10_qp11_qt6_decompJPEG_712x712_Q10",0.676136363636363,89,69,94,89,341
"Orbiter_Space_Shuttle_OV-103_Discovery-150k-4096","Orbiter_Space_Shuttle_OV-103_Discovery-150k-4096_simpL9_qp11_qt6_decompJPEG_2048x2048_Q90",0.904761904761905,32,24,37,9,102
"yourMesh","yourMesh_simpL5_qp9_qt8_decompJPEG_712x712_Q75",0.344444444444445,89,69,94,89,341
"JaneAnne_WithBase","JaneAnne_WithBase_simpL6_qp10_qt7_decompJPEG_512x512_Q90",0.767857142857143,51,37,37,41,166
"diez_BakedUV","diez_BakedUV_simpL10_qp11_qt7_decompJPEG_2048x2048_Q50",0.80813953488372,73,50,54,52,229
"GoldenStatueModel","GoldenStatueModel_simpL9_qp7_qt9_decompJPEG_712x712_Q10",0.96111111111111,40,29,51,32,152
"skiboot_BakedUV","skiboot_BakedUV_simpL6_qp11_qt6_decompJPEG_512x512_Q90",0.744186046511627,90,71,102,102,365
"skiboot_BakedUV","skiboot_BakedUV_simpL4_qp9_qt6_decompJPEG_1024x1024_Q75",0.773809523809525,90,71,102,102,365
"GoldenStatueModel","GoldenStatueModel_simpL9_qp7_qt6_decompJPEG_512x512_Q25",0.9375,40,29,51,32,152
"Orbiter_Space_Shuttle_OV-103_Discovery-150k-4096","Orbiter_Space_Shuttle_OV-103_Discovery-150k-4096_simpL9_qp11_qt6_decompJPEG_1440x1440_Q90",0.93452380952381,32,24,37,9,102
"GeorgeWashington_BakedUV","GeorgeWashington_BakedUV_simpL1_qp9_qt10_decompJPEG_512x512_Q10",0.5,70,40,63,37,210
"AsparnLoewe_C","AsparnLoewe_C_simpL9_qp9_qt10_decompJPEG_512x512_Q90",0.348837209302325,149,137,146,140,572
"Streblognathus","Streblognathus_simpL6_qp7_qt6_decompJPEG_712x712_Q50",0.976190476190475,17,13,9,17,56
"AsparnLoewe_C","AsparnLoewe_C_simpL10_qp9_qt10_decompJPEG_2048x2048_Q50",0.936046511627908,149,137,146,140,572
"AsparnLoewe_C","AsparnLoewe_C_simpL4_qp8_qt10_decompJPEG_2048x2048_Q50",0.886904761904763,149,137,146,140,572
"GoldenStatueModel","GoldenStatueModel_simpL6_qp8_qt10_decompJPEG_512x512_Q10",0.817073170731707,40,29,51,32,152
"GeorgeWashington_BakedUV","GeorgeWashington_BakedUV_simpL7_qp11_qt6_decompJPEG_512x512_Q25",0.72093023255814,70,40,63,37,210
"yourMesh","yourMesh_simpL2_qp11_qt8_decompJPEG_512x512_Q75",0.128048780487805,89,69,94,89,341
"Streblognathus","Streblognathus_simpL4_qp8_qt6_decompJPEG_1440x1440_Q10",0.80813953488372,17,13,9,17,56
"AsparnLoewe_C","AsparnLoewe_C_simpL3_qp9_qt8_decompJPEG_1024x1024_Q25",0.732558139534882,149,137,146,140,572
"diez_BakedUV","diez_BakedUV_simpL9_qp11_qt10_decompJPEG_512x512_Q75",0.101190476190478,73,50,54,52,229
"Orbiter_Space_Shuttle_OV-103_Discovery-150k-4096","Orbiter_Space_Shuttle_OV-103_Discovery-150k-4096_simpL3_qp8_qt10_decompJPEG_712x712_Q75",0.77840909090909,32,24,37,9,102
"GeorgeWashington_BakedUV","GeorgeWashington_BakedUV_simpL3_qp9_qt7_decompJPEG_1440x1440_Q10",0.505681818181817,70,40,63,37,210
"AsparnLoewe_C","AsparnLoewe_C_simpL1_qp9_qt9_decompJPEG_2048x2048_Q25",0.630681818181817,149,137,146,140,572
"Orbiter_Space_Shuttle_OV-103_Discovery-150k-4096","Orbiter_Space_Shuttle_OV-103_Discovery-150k-4096_simpL8_qp8_qt9_decompJPEG_1024x1024_Q25",0.829545454545455,32,24,37,9,102
"JaneAnne_WithBase","JaneAnne_WithBase_simpL1_qp8_qt10_decompJPEG_512x512_Q25",0.69047619047619,51,37,37,41,166
"AsparnLoewe_C","AsparnLoewe_C_simpL9_qp10_qt8_decompJPEG_512x512_Q25",0.51829268292683,149,137,146,140,572
"Streblognathus","Streblognathus_simpL8_qp7_qt6_decompJPEG_2048x2048_Q10",0.965116279069767,17,13,9,17,56
"Graphosoma","Graphosoma_simpL9_qp11_qt6_decompJPEG_1440x1440_Q25",0.33974358974359,35,34,41,33,143
"JaneAnne_WithBase","JaneAnne_WithBase_simpL9_qp9_qt6_decompJPEG_1024x1024_Q25",0.843023255813953,51,37,37,41,166
"GeorgeWashington_BakedUV","GeorgeWashington_BakedUV_simpL2_qp11_qt6_decompJPEG_712x712_Q90",0.720238095238095,70,40,63,37,210
"GoldenStatueModel","GoldenStatueModel_simpL2_qp10_qt9_decompJPEG_1440x1440_Q75",0.363636363636363,40,29,51,32,152
"skiboot_BakedUV","skiboot_BakedUV_simpL3_qp9_qt6_decompJPEG_712x712_Q10",0.814102564102565,90,71,102,102,365
"JaneAnne_WithBase","JaneAnne_WithBase_simpL9_qp8_qt6_decompJPEG_712x712_Q25",0.916666666666668,51,37,37,41,166
"Orbiter_Space_Shuttle_OV-103_Discovery-150k-4096","Orbiter_Space_Shuttle_OV-103_Discovery-150k-4096_simpL9_qp11_qt6_decompJPEG_2048x2048_Q75",0.91860465116279,32,24,37,9,102
"Orbiter_Space_Shuttle_OV-103_Discovery-150k-4096","Orbiter_Space_Shuttle_OV-103_Discovery-150k-4096_simpL4_qp8_qt8_decompJPEG_1440x1440_Q50",0.88095238095238,32,24,37,9,102
"JaneAnne_WithBase","JaneAnne_WithBase_simpL3_qp9_qt6_decompJPEG_512x512_Q75",0.796511627906977,51,37,37,41,166
"skiboot_BakedUV","skiboot_BakedUV_simpL3_qp9_qt6_decompJPEG_1024x1024_Q90",0.786585365853657,90,71,102,102,365
"Boiler","Boiler_simpL7_qp11_qt8_decompJPEG_712x712_Q75",0.174418604651162,51,51,57,51,210
"Orbiter_Space_Shuttle_OV-103_Discovery-150k-4096","Orbiter_Space_Shuttle_OV-103_Discovery-150k-4096_simpL9_qp9_qt6_decompJPEG_1024x1024_Q90",0.93452380952381,32,24,37,9,102
"Streblognathus","Streblognathus_simpL8_qp7_qt7_decompJPEG_512x512_Q10",0.96590909090909,17,13,9,17,56
"Boiler","Boiler_simpL5_qp9_qt8_decompJPEG_1440x1440_Q50",0.482142857142858,51,51,57,51,210
"diez_BakedUV","diez_BakedUV_simpL6_qp11_qt6_decompJPEG_1024x1024_Q75",0.8125,73,50,54,52,229
"diez_BakedUV","diez_BakedUV_simpL8_qp10_qt6_decompJPEG_1024x1024_Q90",0.772727272727272,73,50,54,52,229
"GeorgeWashington_BakedUV","GeorgeWashington_BakedUV_simpL7_qp8_qt9_decompJPEG_2048x2048_Q10",0.714285714285715,70,40,63,37,210
"diez_BakedUV","diez_BakedUV_simpL4_qp10_qt7_decompJPEG_2048x2048_Q25",0.61904761904762,73,50,54,52,229
"Streblognathus","Streblognathus_simpL10_qp9_qt6_decompJPEG_1440x1440_Q50",0.238095238095237,17,13,9,17,56
"GoldenStatueModel","GoldenStatueModel_simpL2_qp10_qt7_decompJPEG_712x712_Q90",0.375,40,29,51,32,152
"AsparnLoewe_C","AsparnLoewe_C_simpL6_qp10_qt7_decompJPEG_712x712_Q10",0.693181818181817,149,137,146,140,572
"yourMesh","yourMesh_simpL1_qp11_qt8_decompJPEG_512x512_Q75",0.1875,89,69,94,89,341
"Orbiter_Space_Shuttle_OV-103_Discovery-150k-4096","Orbiter_Space_Shuttle_OV-103_Discovery-150k-4096_simpL8_qp10_qt9_decompJPEG_1440x1440_Q10",0.65,32,24,37,9,102
"skiboot_BakedUV","skiboot_BakedUV_simpL4_qp9_qt6_decompJPEG_512x512_Q75",0.81111111111111,90,71,102,102,365
"GoldenStatueModel","GoldenStatueModel_simpL9_qp8_qt8_decompJPEG_2048x2048_Q90",0.7,40,29,51,32,152
"diez_BakedUV","diez_BakedUV_simpL6_qp8_qt10_decompJPEG_712x712_Q25",0.676136363636363,73,50,54,52,229
"Boiler","Boiler_simpL7_qp8_qt10_decompJPEG_712x712_Q75",0.607954545454545,51,51,57,51,210
"GeorgeWashington_BakedUV","GeorgeWashington_BakedUV_simpL9_qp11_qt10_decompJPEG_512x512_Q10",0.627906976744185,70,40,63,37,210
"diez_BakedUV","diez_BakedUV_simpL10_qp11_qt9_decompJPEG_2048x2048_Q90",0.670731707317073,73,50,54,52,229
"Streblognathus","Streblognathus_simpL10_qp9_qt6_decompJPEG_2048x2048_Q75",0.267441860465118,17,13,9,17,56
"Streblognathus","Streblognathus_simpL2_qp7_qt6_decompJPEG_2048x2048_Q10",0.964285714285715,17,13,9,17,56
"yourMesh","yourMesh_simpL2_qp10_qt8_decompJPEG_512x512_Q50",0.238095238095237,89,69,94,89,341
"AsparnLoewe_C","AsparnLoewe_C_simpL9_qp9_qt9_decompJPEG_512x512_Q75",0.44767441860465,149,137,146,140,572
"Boiler","Boiler_simpL5_qp8_qt8_decompJPEG_712x712_Q50",0.630681818181817,51,51,57,51,210
"Boiler","Boiler_simpL1_qp9_qt10_decompJPEG_512x512_Q90",0.383720930232557,51,51,57,51,210
"GoldenStatueModel","GoldenStatueModel_simpL6_qp8_qt6_decompJPEG_512x512_Q10",0.843023255813953,40,29,51,32,152
"Streblognathus","Streblognathus_simpL10_qp11_qt6_decompJPEG_1024x1024_Q90",0.323863636363637,17,13,9,17,56
"Boiler","Boiler_simpL2_qp11_qt6_decompJPEG_1440x1440_Q10",0.517045454545455,51,51,57,51,210
"Streblognathus","Streblognathus_simpL3_qp7_qt6_decompJPEG_2048x2048_Q25",0.982142857142857,17,13,9,17,56
"yourMesh","yourMesh_simpL1_qp9_qt8_decompJPEG_512x512_Q10",0.420731707317073,89,69,94,89,341
"Graphosoma","Graphosoma_simpL10_qp9_qt6_decompJPEG_512x512_Q10",0.319767441860465,35,34,41,33,143
"Graphosoma","Graphosoma_simpL2_qp7_qt6_decompJPEG_1024x1024_Q50",0.892045454545455,35,34,41,33,143
"JaneAnne_WithBase","JaneAnne_WithBase_simpL9_qp8_qt6_decompJPEG_1440x1440_Q50",0.9,51,37,37,41,166
"AsparnLoewe_C","AsparnLoewe_C_simpL1_qp9_qt9_decompJPEG_1024x1024_Q75",0.622093023255815,149,137,146,140,572
"Streblognathus","Streblognathus_simpL1_qp8_qt6_decompJPEG_2048x2048_Q50",0.83139534883721,17,13,9,17,56
"Graphosoma","Graphosoma_simpL1_qp7_qt6_decompJPEG_1024x1024_Q90",0.958333333333332,35,34,41,33,143
"skiboot_BakedUV","skiboot_BakedUV_simpL1_qp11_qt6_decompJPEG_512x512_Q90",0.7625,90,71,102,102,365
"skiboot_BakedUV","skiboot_BakedUV_simpL3_qp9_qt6_decompJPEG_1024x1024_Q25",0.78888888888889,90,71,102,102,365
"GoldenStatueModel","GoldenStatueModel_simpL9_qp7_qt6_decompJPEG_1024x1024_Q25",0.95,40,29,51,32,152
"GoldenStatueModel","GoldenStatueModel_simpL2_qp11_qt10_decompJPEG_1440x1440_Q90",0.142857142857143,40,29,51,32,152
"diez_BakedUV","diez_BakedUV_simpL4_qp9_qt10_decompJPEG_512x512_Q10",0.402439024390245,73,50,54,52,229
"JaneAnne_WithBase","JaneAnne_WithBase_simpL9_qp11_qt7_decompJPEG_712x712_Q50",0.732142857142858,51,37,37,41,166
"GoldenStatueModel","GoldenStatueModel_simpL1_qp10_qt7_decompJPEG_1440x1440_Q10",0.424418604651163,40,29,51,32,152
"GeorgeWashington_BakedUV","GeorgeWashington_BakedUV_simpL2_qp11_qt6_decompJPEG_1024x1024_Q75",0.772727272727272,70,40,63,37,210
"Boiler","Boiler_simpL8_qp10_qt10_decompJPEG_512x512_Q90",0.24404761904762,51,51,57,51,210
"JaneAnne_WithBase","JaneAnne_WithBase_simpL9_qp11_qt6_decompJPEG_512x512_Q75",0.801136363636362,51,37,37,41,166
"AsparnLoewe_C","AsparnLoewe_C_simpL9_qp11_qt10_decompJPEG_712x712_Q75",0.175,149,137,146,140,572
"Streblognathus","Streblognathus_simpL10_qp8_qt6_decompJPEG_712x712_Q10",0.444444444444445,17,13,9,17,56
"Boiler","Boiler_simpL7_qp10_qt9_decompJPEG_1440x1440_Q10",0.329268292682927,51,51,57,51,210
"Boiler","Boiler_simpL8_qp10_qt9_decompJPEG_512x512_Q90",0.215116279069768,51,51,57,51,210
"AsparnLoewe_C","AsparnLoewe_C_simpL8_qp8_qt10_decompJPEG_512x512_Q90",0.76829268292683,149,137,146,140,572
"diez_BakedUV","diez_BakedUV_simpL6_qp9_qt10_decompJPEG_512x512_Q10",0.476190476190475,73,50,54,52,229
"skiboot_BakedUV","skiboot_BakedUV_simpL4_qp10_qt6_decompJPEG_712x712_Q75",0.79375,90,71,102,102,365
"skiboot_BakedUV","skiboot_BakedUV_simpL3_qp9_qt6_decompJPEG_512x512_Q90",0.784883720930233,90,71,102,102,365
"Boiler","Boiler_simpL10_qp11_qt7_decompJPEG_2048x2048_Q75",0.738095238095237,51,51,57,51,210
"diez_BakedUV","diez_BakedUV_simpL9_qp11_qt6_decompJPEG_512x512_Q50",0.732142857142858,73,50,54,52,229
"yourMesh","yourMesh_simpL10_qp7_qt7_decompJPEG_512x512_Q25",0.4375,89,69,94,89,341
"Graphosoma","Graphosoma_simpL10_qp9_qt7_decompJPEG_2048x2048_Q25",0.226190476190478,35,34,41,33,143
"skiboot_BakedUV","skiboot_BakedUV_simpL4_qp11_qt6_decompJPEG_1024x1024_Q25",0.72560975609756,90,71,102,102,365
"JaneAnne_WithBase","JaneAnne_WithBase_simpL9_qp9_qt6_decompJPEG_1440x1440_Q10",0.851190476190475,51,37,37,41,166
"Orbiter_Space_Shuttle_OV-103_Discovery-150k-4096","Orbiter_Space_Shuttle_OV-103_Discovery-150k-4096_simpL8_qp8_qt9_decompJPEG_1440x1440_Q10",0.773809523809525,32,24,37,9,102
"Graphosoma","Graphosoma_simpL4_qp7_qt10_decompJPEG_2048x2048_Q25",0.95,35,34,41,33,143
"skiboot_BakedUV","skiboot_BakedUV_simpL3_qp9_qt6_decompJPEG_2048x2048_Q50",0.738372093023255,90,71,102,102,365
"Streblognathus","Streblognathus_simpL6_qp8_qt6_decompJPEG_512x512_Q10",0.766666666666667,17,13,9,17,56
"Graphosoma","Graphosoma_simpL10_qp7_qt6_decompJPEG_1024x1024_Q50",0.232558139534883,35,34,41,33,143
"Streblognathus","Streblognathus_simpL7_qp8_qt7_decompJPEG_2048x2048_Q75",0.71590909090909,17,13,9,17,56
"skiboot_BakedUV","skiboot_BakedUV_simpL3_qp8_qt6_decompJPEG_2048x2048_Q75",0.84659090909091,90,71,102,102,365
"yourMesh","yourMesh_simpL3_qp7_qt10_decompJPEG_1024x1024_Q10",0.813953488372092,89,69,94,89,341
"diez_BakedUV","diez_BakedUV_simpL8_qp11_qt6_decompJPEG_1024x1024_Q90",0.738636363636363,73,50,54,52,229
"Graphosoma","Graphosoma_simpL10_qp9_qt7_decompJPEG_2048x2048_Q75",0.203488372093023,35,34,41,33,143
"JaneAnne_WithBase","JaneAnne_WithBase_simpL2_qp11_qt7_decompJPEG_512x512_Q50",0.66860465116279,51,37,37,41,166
"yourMesh","yourMesh_simpL10_qp9_qt8_decompJPEG_1440x1440_Q75",0.394444444444445,89,69,94,89,341
"GeorgeWashington_BakedUV","GeorgeWashington_BakedUV_simpL7_qp11_qt6_decompJPEG_512x512_Q10",0.773809523809525,70,40,63,37,210
"AsparnLoewe_C","AsparnLoewe_C_simpL9_qp9_qt7_decompJPEG_1440x1440_Q25",0.710227272727272,149,137,146,140,572
"Streblognathus","Streblognathus_simpL3_qp7_qt6_decompJPEG_2048x2048_Q75",0.99404761904762,17,13,9,17,56
"Orbiter_Space_Shuttle_OV-103_Discovery-150k-4096","Orbiter_Space_Shuttle_OV-103_Discovery-150k-4096_simpL8_qp7_qt10_decompJPEG_1024x1024_Q75",0.923076923076922,32,24,37,9,102
"Streblognathus","Streblognathus_simpL8_qp7_qt7_decompJPEG_1024x1024_Q50",0.9625,17,13,9,17,56
"yourMesh","yourMesh_simpL10_qp10_qt9_decompJPEG_2048x2048_Q10",0.422619047619047,89,69,94,89,341
"Streblognathus","Streblognathus_simpL10_qp8_qt7_decompJPEG_512x512_Q10",0.47560975609756,17,13,9,17,56
"GeorgeWashington_BakedUV","GeorgeWashington_BakedUV_simpL9_qp8_qt8_decompJPEG_1440x1440_Q75",0.686046511627908,70,40,63,37,210
"Boiler","Boiler_simpL1_qp11_qt8_decompJPEG_512x512_Q75",0.0988372093023251,51,51,57,51,210
"JaneAnne_WithBase","JaneAnne_WithBase_simpL9_qp9_qt6_decompJPEG_1024x1024_Q10",0.816666666666668,51,37,37,41,166
"JaneAnne_WithBase","JaneAnne_WithBase_simpL8_qp10_qt10_decompJPEG_512x512_Q50",0.380681818181817,51,37,37,41,166
"diez_BakedUV","diez_BakedUV_simpL10_qp11_qt7_decompJPEG_1440x1440_Q90",0.767045454545455,73,50,54,52,229
"yourMesh","yourMesh_simpL3_qp11_qt7_decompJPEG_2048x2048_Q90",0.540697674418605,89,69,94,89,341
"Graphosoma","Graphosoma_simpL9_qp9_qt7_decompJPEG_1024x1024_Q75",0.193181818181817,35,34,41,33,143
"Graphosoma","Graphosoma_simpL10_qp8_qt6_decompJPEG_512x512_Q50",0.238372093023255,35,34,41,33,143
"skiboot_BakedUV","skiboot_BakedUV_simpL6_qp8_qt10_decompJPEG_512x512_Q75",0.583333333333332,90,71,102,102,365
"skiboot_BakedUV","skiboot_BakedUV_simpL1_qp8_qt6_decompJPEG_1440x1440_Q10",0.813953488372092,90,71,102,102,365
"Boiler","Boiler_simpL8_qp11_qt7_decompJPEG_1440x1440_Q50",0.414772727272728,51,51,57,51,210
"skiboot_BakedUV","skiboot_BakedUV_simpL3_qp11_qt6_decompJPEG_512x512_Q90",0.701219512195122,90,71,102,102,365
"AsparnLoewe_C","AsparnLoewe_C_simpL10_qp9_qt6_decompJPEG_2048x2048_Q10",0.965116279069767,149,137,146,140,572
"AsparnLoewe_C","AsparnLoewe_C_simpL9_qp11_qt6_decompJPEG_712x712_Q50",0.827380952380953,149,137,146,140,572
"diez_BakedUV","diez_BakedUV_simpL6_qp9_qt7_decompJPEG_712x712_Q25",0.523255813953488,73,50,54,52,229
"Boiler","Boiler_simpL9_qp9_qt6_decompJPEG_1024x1024_Q50",0.678571428571427,51,51,57,51,210
"Orbiter_Space_Shuttle_OV-103_Discovery-150k-4096","Orbiter_Space_Shuttle_OV-103_Discovery-150k-4096_simpL8_qp11_qt10_decompJPEG_1024x1024_Q75",0.511904761904763,32,24,37,9,102
"JaneAnne_WithBase","JaneAnne_WithBase_simpL9_qp10_qt9_decompJPEG_1024x1024_Q50",0.585227272727272,51,37,37,41,166
"diez_BakedUV","diez_BakedUV_simpL9_qp10_qt7_decompJPEG_2048x2048_Q90",0.44186046511628,73,50,54,52,229
"GeorgeWashington_BakedUV","GeorgeWashington_BakedUV_simpL9_qp10_qt10_decompJPEG_1440x1440_Q50",0.572368421052633,70,40,63,37,210
"skiboot_BakedUV","skiboot_BakedUV_simpL4_qp11_qt6_decompJPEG_712x712_Q90",0.775,90,71,102,102,365
"GoldenStatueModel","GoldenStatueModel_simpL9_qp7_qt10_decompJPEG_512x512_Q75",0.954545454545455,40,29,51,32,152
"Orbiter_Space_Shuttle_OV-103_Discovery-150k-4096","Orbiter_Space_Shuttle_OV-103_Discovery-150k-4096_simpL4_qp10_qt8_decompJPEG_512x512_Q10",0.761363636363638,32,24,37,9,102
"GeorgeWashington_BakedUV","GeorgeWashington_BakedUV_simpL1_qp11_qt6_decompJPEG_2048x2048_Q90",0.77840909090909,70,40,63,37,210
"GoldenStatueModel","GoldenStatueModel_simpL7_qp8_qt9_decompJPEG_2048x2048_Q10",0.86046511627907,40,29,51,32,152
"Boiler","Boiler_simpL10_qp8_qt6_decompJPEG_1440x1440_Q10",0.851190476190475,51,51,57,51,210
"GoldenStatueModel","GoldenStatueModel_simpL9_qp7_qt6_decompJPEG_712x712_Q50",0.982558139534883,40,29,51,32,152
"Graphosoma","Graphosoma_simpL9_qp11_qt6_decompJPEG_1440x1440_Q50",0.410714285714285,35,34,41,33,143
"yourMesh","yourMesh_simpL3_qp7_qt10_decompJPEG_1440x1440_Q90",0.806818181818183,89,69,94,89,341
"GoldenStatueModel","GoldenStatueModel_simpL2_qp10_qt10_decompJPEG_2048x2048_Q50",0.392045454545455,40,29,51,32,152
"Boiler","Boiler_simpL2_qp9_qt10_decompJPEG_2048x2048_Q50",0.436046511627908,51,51,57,51,210
"Orbiter_Space_Shuttle_OV-103_Discovery-150k-4096","Orbiter_Space_Shuttle_OV-103_Discovery-150k-4096_simpL9_qp9_qt6_decompJPEG_1440x1440_Q75",0.930232558139535,32,24,37,9,102
"skiboot_BakedUV","skiboot_BakedUV_simpL1_qp10_qt6_decompJPEG_1024x1024_Q75",0.75,90,71,102,102,365
"diez_BakedUV","diez_BakedUV_simpL9_qp10_qt8_decompJPEG_2048x2048_Q25",0.204545454545455,73,50,54,52,229
"Orbiter_Space_Shuttle_OV-103_Discovery-150k-4096","Orbiter_Space_Shuttle_OV-103_Discovery-150k-4096_simpL9_qp11_qt6_decompJPEG_1024x1024_Q90",0.91860465116279,32,24,37,9,102
"yourMesh","yourMesh_simpL10_qp11_qt7_decompJPEG_2048x2048_Q10",0.348837209302325,89,69,94,89,341
"diez_BakedUV","diez_BakedUV_simpL9_qp10_qt10_decompJPEG_512x512_Q90",0.0813953488372099,73,50,54,52,229
"yourMesh","yourMesh_simpL10_qp10_qt10_decompJPEG_1024x1024_Q50",0.375,89,69,94,89,341
"GeorgeWashington_BakedUV","GeorgeWashington_BakedUV_simpL9_qp7_qt10_decompJPEG_712x712_Q10",0.924418604651162,70,40,63,37,210
"Graphosoma","Graphosoma_simpL10_qp11_qt8_decompJPEG_712x712_Q10",0.273255813953488,35,34,41,33,143
"Streblognathus","Streblognathus_simpL5_qp8_qt7_decompJPEG_2048x2048_Q25",0.738372093023255,17,13,9,17,56
"Boiler","Boiler_simpL10_qp11_qt10_decompJPEG_2048x2048_Q90",0.738636363636363,51,51,57,51,210
"skiboot_BakedUV","skiboot_BakedUV_simpL3_qp11_qt6_decompJPEG_512x512_Q75",0.75595238095238,90,71,102,102,365
"JaneAnne_WithBase","JaneAnne_WithBase_simpL9_qp10_qt6_decompJPEG_1024x1024_Q50",0.796511627906977,51,37,37,41,166
"yourMesh","yourMesh_simpL10_qp10_qt7_decompJPEG_1440x1440_Q90",0.416666666666668,89,69,94,89,341
"yourMesh","yourMesh_simpL4_qp11_qt8_decompJPEG_512x512_Q50",0.125,89,69,94,89,341
"GeorgeWashington_BakedUV","GeorgeWashington_BakedUV_simpL9_qp8_qt10_decompJPEG_512x512_Q75",0.74375,70,40,63,37,210
"AsparnLoewe_C","AsparnLoewe_C_simpL1_qp11_qt8_decompJPEG_712x712_Q10",0.59090909090909,149,137,146,140,572
"AsparnLoewe_C","AsparnLoewe_C_simpL6_qp8_qt10_decompJPEG_2048x2048_Q50",0.869318181818183,149,137,146,140,572
"JaneAnne_WithBase","JaneAnne_WithBase_simpL9_qp11_qt6_decompJPEG_512x512_Q10",0.80952380952381,51,37,37,41,166
"diez_BakedUV","diez_BakedUV_simpL8_qp10_qt6_decompJPEG_2048x2048_Q90",0.777777777777777,73,50,54,52,229
"Graphosoma","Graphosoma_simpL6_qp11_qt6_decompJPEG_1440x1440_Q25",0.505813953488373,35,34,41,33,143
"Streblognathus","Streblognathus_simpL8_qp7_qt7_decompJPEG_1440x1440_Q50",0.951219512195123,17,13,9,17,56
"yourMesh","yourMesh_simpL3_qp11_qt8_decompJPEG_512x512_Q75",0.166666666666667,89,69,94,89,341
"Graphosoma","Graphosoma_simpL1_qp8_qt8_decompJPEG_712x712_Q50",0.636904761904763,35,34,41,33,143
"JaneAnne_WithBase","JaneAnne_WithBase_simpL5_qp11_qt7_decompJPEG_512x512_Q90",0.698717948717947,51,37,37,41,166
"Graphosoma","Graphosoma_simpL1_qp7_qt6_decompJPEG_2048x2048_Q75",0.928571428571427,35,34,41,33,143
"Boiler","Boiler_simpL1_qp11_qt6_decompJPEG_512x512_Q50",0.4375,51,51,57,51,210
"Boiler","Boiler_simpL8_qp8_qt9_decompJPEG_512x512_Q25",0.645348837209302,51,51,57,51,210
"GeorgeWashington_BakedUV","GeorgeWashington_BakedUV_simpL9_qp8_qt8_decompJPEG_1024x1024_Q50",0.73076923076923,70,40,63,37,210
"Orbiter_Space_Shuttle_OV-103_Discovery-150k-4096","Orbiter_Space_Shuttle_OV-103_Discovery-150k-4096_simpL8_qp8_qt8_decompJPEG_1024x1024_Q25",0.843023255813953,32,24,37,9,102
"Streblognathus","Streblognathus_simpL10_qp7_qt10_decompJPEG_512x512_Q10",0.556818181818183,17,13,9,17,56
"AsparnLoewe_C","AsparnLoewe_C_simpL2_qp11_qt10_decompJPEG_712x712_Q25",0.255813953488373,149,137,146,140,572
"Boiler","Boiler_simpL10_qp9_qt10_decompJPEG_2048x2048_Q90",0.702380952380953,51,51,57,51,210
"Graphosoma","Graphosoma_simpL9_qp10_qt6_decompJPEG_1440x1440_Q50",0.430232558139535,35,34,41,33,143
"Streblognathus","Streblognathus_simpL5_qp7_qt9_decompJPEG_2048x2048_Q10",0.977777777777778,17,13,9,17,56
"diez_BakedUV","diez_BakedUV_simpL8_qp8_qt10_decompJPEG_1440x1440_Q10",0.604651162790698,73,50,54,52,229
"Orbiter_Space_Shuttle_OV-103_Discovery-150k-4096","Orbiter_Space_Shuttle_OV-103_Discovery-150k-4096_simpL3_qp9_qt8_decompJPEG_1024x1024_Q50",0.733333333333333,32,24,37,9,102
"Streblognathus","Streblognathus_simpL9_qp8_qt9_decompJPEG_1024x1024_Q10",0.656976744186047,17,13,9,17,56
"Streblognathus","Streblognathus_simpL6_qp8_qt7_decompJPEG_1440x1440_Q50",0.69186046511628,17,13,9,17,56
"Graphosoma","Graphosoma_simpL1_qp8_qt7_decompJPEG_712x712_Q90",0.630681818181817,35,34,41,33,143
"diez_BakedUV","diez_BakedUV_simpL8_qp11_qt7_decompJPEG_1440x1440_Q50",0.44767441860465,73,50,54,52,229
"skiboot_BakedUV","skiboot_BakedUV_simpL3_qp9_qt6_decompJPEG_2048x2048_Q10",0.785714285714285,90,71,102,102,365
"AsparnLoewe_C","AsparnLoewe_C_simpL1_qp9_qt9_decompJPEG_712x712_Q50",0.702380952380953,149,137,146,140,572
"Boiler","Boiler_simpL4_qp7_qt10_decompJPEG_2048x2048_Q10",0.901162790697675,51,51,57,51,210
"Graphosoma","Graphosoma_simpL10_qp9_qt8_decompJPEG_712x712_Q10",0.31875,35,34,41,33,143
"Orbiter_Space_Shuttle_OV-103_Discovery-150k-4096","Orbiter_Space_Shuttle_OV-103_Discovery-150k-4096_simpL8_qp9_qt9_decompJPEG_1024x1024_Q50",0.733333333333333,32,24,37,9,102
"AsparnLoewe_C","AsparnLoewe_C_simpL8_qp11_qt6_decompJPEG_1024x1024_Q10",0.886904761904763,149,137,146,140,572
"GoldenStatueModel","GoldenStatueModel_simpL9_qp7_qt6_decompJPEG_2048x2048_Q25",0.965116279069767,40,29,51,32,152
"Boiler","Boiler_simpL8_qp11_qt6_decompJPEG_2048x2048_Q90",0.598837209302325,51,51,57,51,210
"skiboot_BakedUV","skiboot_BakedUV_simpL4_qp11_qt6_decompJPEG_512x512_Q90",0.80952380952381,90,71,102,102,365
"GoldenStatueModel","GoldenStatueModel_simpL9_qp7_qt6_decompJPEG_512x512_Q90",0.964285714285715,40,29,51,32,152
"Boiler","Boiler_simpL7_qp11_qt8_decompJPEG_512x512_Q10",0.465116279069767,51,51,57,51,210
"Boiler","Boiler_simpL8_qp11_qt6_decompJPEG_1024x1024_Q75",0.61111111111111,51,51,57,51,210
"yourMesh","yourMesh_simpL10_qp10_qt9_decompJPEG_1024x1024_Q75",0.35,89,69,94,89,341
"Orbiter_Space_Shuttle_OV-103_Discovery-150k-4096","Orbiter_Space_Shuttle_OV-103_Discovery-150k-4096_simpL9_qp7_qt6_decompJPEG_1440x1440_Q75",0.930232558139535,32,24,37,9,102
"JaneAnne_WithBase","JaneAnne_WithBase_simpL4_qp9_qt10_decompJPEG_512x512_Q50",0.386363636363637,51,37,37,41,166
"skiboot_BakedUV","skiboot_BakedUV_simpL1_qp11_qt6_decompJPEG_1024x1024_Q75",0.790697674418605,90,71,102,102,365
"Orbiter_Space_Shuttle_OV-103_Discovery-150k-4096","Orbiter_Space_Shuttle_OV-103_Discovery-150k-4096_simpL5_qp8_qt9_decompJPEG_512x512_Q25",0.813953488372092,32,24,37,9,102
"Boiler","Boiler_simpL10_qp8_qt7_decompJPEG_512x512_Q10",0.80952380952381,51,51,57,51,210
"AsparnLoewe_C","AsparnLoewe_C_simpL9_qp9_qt7_decompJPEG_1024x1024_Q75",0.72560975609756,149,137,146,140,572
"skiboot_BakedUV","skiboot_BakedUV_simpL5_qp11_qt6_decompJPEG_512x512_Q90",0.732954545454545,90,71,102,102,365
"GoldenStatueModel","GoldenStatueModel_simpL7_qp9_qt10_decompJPEG_512x512_Q10",0.60625,40,29,51,32,152
"AsparnLoewe_C","AsparnLoewe_C_simpL9_qp8_qt8_decompJPEG_1024x1024_Q25",0.761904761904763,149,137,146,140,572
"GoldenStatueModel","GoldenStatueModel_simpL6_qp9_qt6_decompJPEG_1024x1024_Q90",0.5875,40,29,51,32,152
"Streblognathus","Streblognathus_simpL1_qp11_qt7_decompJPEG_1440x1440_Q75",0.345238095238095,17,13,9,17,56
"Streblognathus","Streblognathus_simpL8_qp8_qt8_decompJPEG_712x712_Q90",0.642045454545455,17,13,9,17,56
"GeorgeWashington_BakedUV","GeorgeWashington_BakedUV_simpL5_qp9_qt7_decompJPEG_712x712_Q10",0.523809523809525,70,40,63,37,210
"Streblognathus","Streblognathus_simpL9_qp8_qt7_decompJPEG_2048x2048_Q90",0.63953488372093,17,13,9,17,56
"GeorgeWashington_BakedUV","GeorgeWashington_BakedUV_simpL4_qp8_qt7_decompJPEG_1440x1440_Q10",0.76875,70,40,63,37,210
"Boiler","Boiler_simpL10_qp11_qt9_decompJPEG_1440x1440_Q25",0.726190476190475,51,51,57,51,210
"Orbiter_Space_Shuttle_OV-103_Discovery-150k-4096","Orbiter_Space_Shuttle_OV-103_Discovery-150k-4096_simpL7_qp8_qt10_decompJPEG_1024x1024_Q25",0.767857142857143,32,24,37,9,102
"Graphosoma","Graphosoma_simpL3_qp11_qt6_decompJPEG_1024x1024_Q25",0.5,35,34,41,33,143
"diez_BakedUV","diez_BakedUV_simpL10_qp9_qt9_decompJPEG_2048x2048_Q90",0.77840909090909,73,50,54,52,229
"diez_BakedUV","diez_BakedUV_simpL9_qp9_qt9_decompJPEG_2048x2048_Q10",0.286585365853657,73,50,54,52,229
"diez_BakedUV","diez_BakedUV_simpL9_qp9_qt10_decompJPEG_512x512_Q75",0.244186046511627,73,50,54,52,229
"GoldenStatueModel","GoldenStatueModel_simpL9_qp7_qt10_decompJPEG_512x512_Q50",0.960227272727272,40,29,51,32,152
"diez_BakedUV","diez_BakedUV_simpL9_qp10_qt7_decompJPEG_1440x1440_Q50",0.40625,73,50,54,52,229
"yourMesh","yourMesh_simpL1_qp11_qt8_decompJPEG_1024x1024_Q25",0.22093023255814,89,69,94,89,341
"JaneAnne_WithBase","JaneAnne_WithBase_simpL6_qp9_qt6_decompJPEG_512x512_Q75",0.767857142857143,51,37,37,41,166
"Boiler","Boiler_simpL10_qp10_qt9_decompJPEG_2048x2048_Q75",0.71590909090909,51,51,57,51,210
"diez_BakedUV","diez_BakedUV_simpL6_qp11_qt7_decompJPEG_2048x2048_Q50",0.548780487804878,73,50,54,52,229
"GoldenStatueModel","GoldenStatueModel_simpL6_qp10_qt8_decompJPEG_1024x1024_Q25",0.404761904761905,40,29,51,32,152
"AsparnLoewe_C","AsparnLoewe_C_simpL7_qp7_qt10_decompJPEG_2048x2048_Q25",0.9875,149,137,146,140,572
"Graphosoma","Graphosoma_simpL9_qp10_qt6_decompJPEG_1024x1024_Q75",0.386363636363637,35,34,41,33,143
"GoldenStatueModel","GoldenStatueModel_simpL1_qp10_qt6_decompJPEG_1440x1440_Q50",0.40909090909091,40,29,51,32,152
"Boiler","Boiler_simpL9_qp11_qt7_decompJPEG_712x712_Q50",0.41875,51,51,57,51,210
"Graphosoma","Graphosoma_simpL2_qp8_qt9_decompJPEG_1440x1440_Q50",0.607142857142858,35,34,41,33,143
"AsparnLoewe_C","AsparnLoewe_C_simpL7_qp7_qt10_decompJPEG_2048x2048_Q75",0.982558139534883,149,137,146,140,572
"GoldenStatueModel","GoldenStatueModel_simpL8_qp9_qt8_decompJPEG_512x512_Q10",0.494186046511627,40,29,51,32,152
"skiboot_BakedUV","skiboot_BakedUV_simpL3_qp9_qt6_decompJPEG_2048x2048_Q25",0.801136363636362,90,71,102,102,365
"Orbiter_Space_Shuttle_OV-103_Discovery-150k-4096","Orbiter_Space_Shuttle_OV-103_Discovery-150k-4096_simpL5_qp8_qt10_decompJPEG_1440x1440_Q50",0.785714285714285,32,24,37,9,102
"GoldenStatueModel","GoldenStatueModel_simpL4_qp8_qt10_decompJPEG_2048x2048_Q10",0.90340909090909,40,29,51,32,152
"Orbiter_Space_Shuttle_OV-103_Discovery-150k-4096","Orbiter_Space_Shuttle_OV-103_Discovery-150k-4096_simpL2_qp11_qt8_decompJPEG_512x512_Q25",0.63095238095238,32,24,37,9,102
"GeorgeWashington_BakedUV","GeorgeWashington_BakedUV_simpL9_qp9_qt8_decompJPEG_512x512_Q90",0.575581395348837,70,40,63,37,210
"diez_BakedUV","diez_BakedUV_simpL10_qp11_qt7_decompJPEG_1024x1024_Q75",0.827380952380953,73,50,54,52,229
"GeorgeWashington_BakedUV","GeorgeWashington_BakedUV_simpL4_qp11_qt6_decompJPEG_712x712_Q25",0.696428571428573,70,40,63,37,210
"skiboot_BakedUV","skiboot_BakedUV_simpL6_qp9_qt10_decompJPEG_512x512_Q25",0.553571428571427,90,71,102,102,365
"AsparnLoewe_C","AsparnLoewe_C_simpL7_qp9_qt7_decompJPEG_2048x2048_Q25",0.777777777777777,149,137,146,140,572
"JaneAnne_WithBase","JaneAnne_WithBase_simpL1_qp11_qt7_decompJPEG_512x512_Q50",0.738372093023255,51,37,37,41,166
"JaneAnne_WithBase","JaneAnne_WithBase_simpL9_qp9_qt6_decompJPEG_512x512_Q10",0.845238095238095,51,37,37,41,166
"AsparnLoewe_C","AsparnLoewe_C_simpL6_qp7_qt10_decompJPEG_2048x2048_Q75",0.994318181818183,149,137,146,140,572
"diez_BakedUV","diez_BakedUV_simpL9_qp9_qt8_decompJPEG_2048x2048_Q50",0.285714285714285,73,50,54,52,229
"Boiler","Boiler_simpL5_qp7_qt10_decompJPEG_2048x2048_Q75",0.880681818181817,51,51,57,51,210
"Streblognathus","Streblognathus_simpL4_qp8_qt6_decompJPEG_1440x1440_Q25",0.75,17,13,9,17,56
"skiboot_BakedUV","skiboot_BakedUV_simpL4_qp8_qt6_decompJPEG_1440x1440_Q10",0.88953488372093,90,71,102,102,365
"JaneAnne_WithBase","JaneAnne_WithBase_simpL1_qp8_qt10_decompJPEG_512x512_Q50",0.630681818181817,51,37,37,41,166
"Graphosoma","Graphosoma_simpL10_qp9_qt6_decompJPEG_2048x2048_Q10",0.220238095238095,35,34,41,33,143
"GeorgeWashington_BakedUV","GeorgeWashington_BakedUV_simpL6_qp8_qt9_decompJPEG_2048x2048_Q10",0.709302325581395,70,40,63,37,210
"diez_BakedUV","diez_BakedUV_simpL1_qp11_qt7_decompJPEG_512x512_Q25",0.511627906976745,73,50,54,52,229
"GeorgeWashington_BakedUV","GeorgeWashington_BakedUV_simpL2_qp11_qt6_decompJPEG_2048x2048_Q90",0.726190476190475,70,40,63,37,210
"Boiler","Boiler_simpL10_qp8_qt6_decompJPEG_1024x1024_Q50",0.801136363636362,51,51,57,51,210
"AsparnLoewe_C","AsparnLoewe_C_simpL3_qp10_qt8_decompJPEG_1024x1024_Q75",0.553571428571427,149,137,146,140,572
"Orbiter_Space_Shuttle_OV-103_Discovery-150k-4096","Orbiter_Space_Shuttle_OV-103_Discovery-150k-4096_simpL5_qp11_qt7_decompJPEG_512x512_Q90",0.821428571428573,32,24,37,9,102
"AsparnLoewe_C","AsparnLoewe_C_simpL8_qp8_qt9_decompJPEG_2048x2048_Q50",0.790697674418605,149,137,146,140,572
"Orbiter_Space_Shuttle_OV-103_Discovery-150k-4096","Orbiter_Space_Shuttle_OV-103_Discovery-150k-4096_simpL9_qp7_qt6_decompJPEG_1440x1440_Q90",0.93125,32,24,37,9,102
"skiboot_BakedUV","skiboot_BakedUV_simpL6_qp7_qt6_decompJPEG_712x712_Q75",0.9625,90,71,102,102,365
"yourMesh","yourMesh_simpL3_qp9_qt8_decompJPEG_1440x1440_Q25",0.398809523809525,89,69,94,89,341
"yourMesh","yourMesh_simpL10_qp7_qt7_decompJPEG_2048x2048_Q10",0.47093023255814,89,69,94,89,341
"JaneAnne_WithBase","JaneAnne_WithBase_simpL9_qp9_qt9_decompJPEG_2048x2048_Q25",0.541666666666668,51,37,37,41,166
"skiboot_BakedUV","skiboot_BakedUV_simpL5_qp8_qt10_decompJPEG_512x512_Q25",0.692307692307693,90,71,102,102,365
"Graphosoma","Graphosoma_simpL10_qp9_qt6_decompJPEG_512x512_Q25",0.2375,35,34,41,33,143
"AsparnLoewe_C","AsparnLoewe_C_simpL6_qp8_qt8_decompJPEG_2048x2048_Q50",0.958333333333332,149,137,146,140,572
"JaneAnne_WithBase","JaneAnne_WithBase_simpL9_qp8_qt6_decompJPEG_512x512_Q10",0.88125,51,37,37,41,166
"Streblognathus","Streblognathus_simpL8_qp8_qt6_decompJPEG_712x712_Q25",0.75,17,13,9,17,56
"Streblognathus","Streblognathus_simpL8_qp7_qt9_decompJPEG_512x512_Q75",0.982142857142857,17,13,9,17,56
"GoldenStatueModel","GoldenStatueModel_simpL7_qp9_qt7_decompJPEG_512x512_Q90",0.589285714285715,40,29,51,32,152
"Boiler","Boiler_simpL6_qp9_qt6_decompJPEG_1024x1024_Q50",0.568181818181817,51,51,57,51,210
"AsparnLoewe_C","AsparnLoewe_C_simpL5_qp8_qt10_decompJPEG_2048x2048_Q75",0.869318181818183,149,137,146,140,572
"Boiler","Boiler_simpL9_qp9_qt10_decompJPEG_512x512_Q25",0.351190476190475,51,51,57,51,210
"JaneAnne_WithBase","JaneAnne_WithBase_simpL6_qp8_qt10_decompJPEG_1024x1024_Q25",0.666666666666668,51,37,37,41,166
"Orbiter_Space_Shuttle_OV-103_Discovery-150k-4096","Orbiter_Space_Shuttle_OV-103_Discovery-150k-4096_simpL9_qp9_qt9_decompJPEG_1024x1024_Q25",0.725,32,24,37,9,102
"Graphosoma","Graphosoma_simpL9_qp11_qt6_decompJPEG_2048x2048_Q10",0.463414634146343,35,34,41,33,143
"skiboot_BakedUV","skiboot_BakedUV_simpL4_qp10_qt6_decompJPEG_512x512_Q90",0.76829268292683,90,71,102,102,365
"diez_BakedUV","diez_BakedUV_simpL10_qp9_qt7_decompJPEG_2048x2048_Q50",0.738636363636363,73,50,54,52,229
"skiboot_BakedUV","skiboot_BakedUV_simpL5_qp9_qt6_decompJPEG_512x512_Q90",0.795454545454545,90,71,102,102,365
"JaneAnne_WithBase","JaneAnne_WithBase_simpL2_qp8_qt10_decompJPEG_512x512_Q50",0.652439024390245,51,37,37,41,166
"Streblognathus","Streblognathus_simpL5_qp8_qt7_decompJPEG_1440x1440_Q90",0.80232558139535,17,13,9,17,56
"Graphosoma","Graphosoma_simpL1_qp7_qt6_decompJPEG_2048x2048_Q50",0.96590909090909,35,34,41,33,143
"GoldenStatueModel","GoldenStatueModel_simpL7_qp7_qt6_decompJPEG_1024x1024_Q10",1,40,29,51,32,152
"AsparnLoewe_C","AsparnLoewe_C_simpL9_qp9_qt9_decompJPEG_512x512_Q90",0.395348837209302,149,137,146,140,572
"Graphosoma","Graphosoma_simpL4_qp8_qt10_decompJPEG_1440x1440_Q25",0.546511627906977,35,34,41,33,143
"yourMesh","yourMesh_simpL7_qp9_qt8_decompJPEG_2048x2048_Q25",0.292682926829268,89,69,94,89,341
"diez_BakedUV","diez_BakedUV_simpL9_qp9_qt10_decompJPEG_512x512_Q50",0.261904761904763,73,50,54,52,229
"Boiler","Boiler_simpL5_qp9_qt7_decompJPEG_512x512_Q75",0.542682926829268,51,51,57,51,210
"Graphosoma","Graphosoma_simpL1_qp7_qt6_decompJPEG_1024x1024_Q50",0.964285714285715,35,34,41,33,143
"Boiler","Boiler_simpL9_qp11_qt7_decompJPEG_1440x1440_Q75",0.454545454545455,51,51,57,51,210
"AsparnLoewe_C","AsparnLoewe_C_simpL2_qp9_qt9_decompJPEG_712x712_Q25",0.7,149,137,146,140,572
"Graphosoma","Graphosoma_simpL10_qp9_qt7_decompJPEG_512x512_Q10",0.33139534883721,35,34,41,33,143
"JaneAnne_WithBase","JaneAnne_WithBase_simpL9_qp10_qt7_decompJPEG_712x712_Q50",0.835227272727272,51,37,37,41,166
"Streblognathus","Streblognathus_simpL10_qp9_qt6_decompJPEG_712x712_Q25",0.205555555555555,17,13,9,17,56
"Boiler","Boiler_simpL1_qp9_qt9_decompJPEG_512x512_Q90",0.448717948717947,51,51,57,51,210
"GoldenStatueModel","GoldenStatueModel_simpL1_qp10_qt7_decompJPEG_712x712_Q25",0.41860465116279,40,29,51,32,152
"GeorgeWashington_BakedUV","GeorgeWashington_BakedUV_simpL1_qp9_qt10_decompJPEG_1024x1024_Q10",0.459302325581395,70,40,63,37,210
"AsparnLoewe_C","AsparnLoewe_C_simpL9_qp10_qt9_decompJPEG_512x512_Q90",0.316666666666668,149,137,146,140,572
"GoldenStatueModel","GoldenStatueModel_simpL8_qp10_qt6_decompJPEG_1440x1440_Q10",0.36904761904762,40,29,51,32,152
"Orbiter_Space_Shuttle_OV-103_Discovery-150k-4096","Orbiter_Space_Shuttle_OV-103_Discovery-150k-4096_simpL4_qp9_qt10_decompJPEG_512x512_Q50",0.53409090909091,32,24,37,9,102
"JaneAnne_WithBase","JaneAnne_WithBase_simpL9_qp9_qt10_decompJPEG_512x512_Q50",0.386904761904763,51,37,37,41,166
"AsparnLoewe_C","AsparnLoewe_C_simpL2_qp11_qt10_decompJPEG_512x512_Q10",0.573863636363637,149,137,146,140,572
"GoldenStatueModel","GoldenStatueModel_simpL9_qp7_qt10_decompJPEG_1024x1024_Q75",0.953488372093023,40,29,51,32,152
"Streblognathus","Streblognathus_simpL8_qp7_qt7_decompJPEG_1440x1440_Q25",0.9875,17,13,9,17,56
"skiboot_BakedUV","skiboot_BakedUV_simpL4_qp11_qt6_decompJPEG_1024x1024_Q75",0.73888888888889,90,71,102,102,365
"GoldenStatueModel","GoldenStatueModel_simpL4_qp8_qt9_decompJPEG_2048x2048_Q10",0.916666666666668,40,29,51,32,152
"yourMesh","yourMesh_simpL10_qp10_qt7_decompJPEG_2048x2048_Q90",0.446428571428573,89,69,94,89,341
"diez_BakedUV","diez_BakedUV_simpL8_qp11_qt10_decompJPEG_512x512_Q75",0.0625,73,50,54,52,229
"Orbiter_Space_Shuttle_OV-103_Discovery-150k-4096","Orbiter_Space_Shuttle_OV-103_Discovery-150k-4096_simpL9_qp11_qt6_decompJPEG_1440x1440_Q50",0.883720930232557,32,24,37,9,102
"GeorgeWashington_BakedUV","GeorgeWashington_BakedUV_simpL2_qp11_qt6_decompJPEG_2048x2048_Q50",0.7,70,40,63,37,210
"skiboot_BakedUV","skiboot_BakedUV_simpL3_qp10_qt6_decompJPEG_512x512_Q90",0.738372093023255,90,71,102,102,365
"GeorgeWashington_BakedUV","GeorgeWashington_BakedUV_simpL1_qp9_qt7_decompJPEG_1440x1440_Q10",0.494186046511627,70,40,63,37,210
"AsparnLoewe_C","AsparnLoewe_C_simpL5_qp11_qt7_decompJPEG_512x512_Q90",0.625,149,137,146,140,572
"GoldenStatueModel","GoldenStatueModel_simpL2_qp9_qt8_decompJPEG_1024x1024_Q75",0.674418604651163,40,29,51,32,152
"skiboot_BakedUV","skiboot_BakedUV_simpL7_qp7_qt6_decompJPEG_712x712_Q75",0.97093023255814,90,71,102,102,365
"skiboot_BakedUV","skiboot_BakedUV_simpL1_qp8_qt9_decompJPEG_512x512_Q50",0.655555555555555,90,71,102,102,365
"yourMesh","yourMesh_simpL5_qp7_qt9_decompJPEG_512x512_Q10",0.80952380952381,89,69,94,89,341
"yourMesh","yourMesh_simpL3_qp9_qt8_decompJPEG_1024x1024_Q10",0.395348837209302,89,69,94,89,341
"GoldenStatueModel","GoldenStatueModel_simpL6_qp11_qt6_decompJPEG_512x512_Q50",0.27840909090909,40,29,51,32,152
"GeorgeWashington_BakedUV","GeorgeWashington_BakedUV_simpL2_qp11_qt6_decompJPEG_1024x1024_Q50",0.698863636363637,70,40,63,37,210
"Orbiter_Space_Shuttle_OV-103_Discovery-150k-4096","Orbiter_Space_Shuttle_OV-103_Discovery-150k-4096_simpL9_qp11_qt6_decompJPEG_1024x1024_Q10",0.93452380952381,32,24,37,9,102
"Streblognathus","Streblognathus_simpL8_qp7_qt6_decompJPEG_512x512_Q25",0.976744186046512,17,13,9,17,56
"skiboot_BakedUV","skiboot_BakedUV_simpL3_qp9_qt6_decompJPEG_1440x1440_Q25",0.833333333333332,90,71,102,102,365
"yourMesh","yourMesh_simpL4_qp11_qt8_decompJPEG_712x712_Q90",0.27840909090909,89,69,94,89,341
"Orbiter_Space_Shuttle_OV-103_Discovery-150k-4096","Orbiter_Space_Shuttle_OV-103_Discovery-150k-4096_simpL4_qp11_qt7_decompJPEG_1024x1024_Q50",0.857954545454545,32,24,37,9,102
"GeorgeWashington_BakedUV","GeorgeWashington_BakedUV_simpL2_qp11_qt6_decompJPEG_2048x2048_Q25",0.75625,70,40,63,37,210
"AsparnLoewe_C","AsparnLoewe_C_simpL4_qp10_qt10_decompJPEG_512x512_Q25",0.453488372093023,149,137,146,140,572
"Graphosoma","Graphosoma_simpL9_qp11_qt6_decompJPEG_1440x1440_Q75",0.402439024390245,35,34,41,33,143
"skiboot_BakedUV","skiboot_BakedUV_simpL8_qp10_qt8_decompJPEG_512x512_Q75",0.511904761904763,90,71,102,102,365
"Streblognathus","Streblognathus_simpL7_qp8_qt7_decompJPEG_2048x2048_Q50",0.726190476190475,17,13,9,17,56
"yourMesh","yourMesh_simpL10_qp7_qt7_decompJPEG_2048x2048_Q75",0.392857142857142,89,69,94,89,341
"Orbiter_Space_Shuttle_OV-103_Discovery-150k-4096","Orbiter_Space_Shuttle_OV-103_Discovery-150k-4096_simpL1_qp10_qt8_decompJPEG_512x512_Q75",0.59659090909091,32,24,37,9,102
"Streblognathus","Streblognathus_simpL3_qp7_qt6_decompJPEG_2048x2048_Q50",0.964285714285715,17,13,9,17,56
"Orbiter_Space_Shuttle_OV-103_Discovery-150k-4096","Orbiter_Space_Shuttle_OV-103_Discovery-150k-4096_simpL6_qp9_qt8_decompJPEG_512x512_Q50",0.732558139534882,32,24,37,9,102
"Streblognathus","Streblognathus_simpL8_qp7_qt7_decompJPEG_1024x1024_Q25",0.926136363636362,17,13,9,17,56
"JaneAnne_WithBase","JaneAnne_WithBase_simpL3_qp10_qt7_decompJPEG_512x512_Q90",0.773255813953488,51,37,37,41,166
"Orbiter_Space_Shuttle_OV-103_Discovery-150k-4096","Orbiter_Space_Shuttle_OV-103_Discovery-150k-4096_simpL6_qp11_qt7_decompJPEG_512x512_Q90",0.827777777777778,32,24,37,9,102
"diez_BakedUV","diez_BakedUV_simpL9_qp8_qt10_decompJPEG_2048x2048_Q10",0.523255813953488,73,50,54,52,229
"Orbiter_Space_Shuttle_OV-103_Discovery-150k-4096","Orbiter_Space_Shuttle_OV-103_Discovery-150k-4096_simpL7_qp11_qt8_decompJPEG_512x512_Q25",0.732954545454545,32,24,37,9,102
"Graphosoma","Graphosoma_simpL9_qp10_qt8_decompJPEG_1440x1440_Q75",0.142857142857143,35,34,41,33,143
"yourMesh","yourMesh_simpL1_qp8_qt9_decompJPEG_712x712_Q50",0.517045454545455,89,69,94,89,341
"JaneAnne_WithBase","JaneAnne_WithBase_simpL9_qp8_qt6_decompJPEG_2048x2048_Q50",0.880681818181817,51,37,37,41,166
"JaneAnne_WithBase","JaneAnne_WithBase_simpL2_qp10_qt9_decompJPEG_2048x2048_Q50",0.585227272727272,51,37,37,41,166
"skiboot_BakedUV","skiboot_BakedUV_simpL1_qp8_qt6_decompJPEG_1440x1440_Q25",0.930232558139535,90,71,102,102,365
"yourMesh","yourMesh_simpL10_qp7_qt8_decompJPEG_1024x1024_Q25",0.452380952380953,89,69,94,89,341
"AsparnLoewe_C","AsparnLoewe_C_simpL9_qp9_qt10_decompJPEG_512x512_Q75",0.416666666666668,149,137,146,140,572
"yourMesh","yourMesh_simpL10_qp7_qt7_decompJPEG_712x712_Q50",0.476744186046512,89,69,94,89,341
"GeorgeWashington_BakedUV","GeorgeWashington_BakedUV_simpL6_qp9_qt10_decompJPEG_512x512_Q10",0.539772727272728,70,40,63,37,210
"yourMesh","yourMesh_simpL1_qp10_qt8_decompJPEG_512x512_Q50",0.267441860465118,89,69,94,89,341
"skiboot_BakedUV","skiboot_BakedUV_simpL4_qp11_qt6_decompJPEG_1024x1024_Q90",0.77840909090909,90,71,102,102,365
"yourMesh","yourMesh_simpL6_qp7_qt9_decompJPEG_1024x1024_Q10",0.720238095238095,89,69,94,89,341
"GoldenStatueModel","GoldenStatueModel_simpL9_qp7_qt6_decompJPEG_1024x1024_Q50",0.976190476190475,40,29,51,32,152
"Streblognathus","Streblognathus_simpL2_qp7_qt9_decompJPEG_1440x1440_Q10",0.988372093023255,17,13,9,17,56
"GoldenStatueModel","GoldenStatueModel_simpL2_qp9_qt6_decompJPEG_1024x1024_Q25",0.732142857142858,40,29,51,32,152
"Boiler","Boiler_simpL10_qp9_qt6_decompJPEG_712x712_Q25",0.772727272727272,51,51,57,51,210
"AsparnLoewe_C","AsparnLoewe_C_simpL5_qp11_qt7_decompJPEG_1440x1440_Q50",0.65909090909091,149,137,146,140,572
"JaneAnne_WithBase","JaneAnne_WithBase_simpL1_qp11_qt7_decompJPEG_512x512_Q25",0.715116279069767,51,37,37,41,166
"JaneAnne_WithBase","JaneAnne_WithBase_simpL1_qp8_qt9_decompJPEG_512x512_Q25",0.75,51,37,37,41,166
"skiboot_BakedUV","skiboot_BakedUV_simpL8_qp10_qt10_decompJPEG_2048x2048_Q75",0.267441860465118,90,71,102,102,365
"JaneAnne_WithBase","JaneAnne_WithBase_simpL9_qp11_qt6_decompJPEG_1024x1024_Q50",0.795454545454545,51,37,37,41,166
