"Model","stimulus","MOS","VP1","VP2","VP3","VP4","TotalPatches"
"rescue_craft","rescue_craft_simpL9_qp11_qt8_decompJPEG_1024x1024_Q50",0.452380952380953,94,77,72,69,312
"Elephant_zun_bakedUV","Elephant_zun_bakedUV_simpL6_qp9_qt8_decompJPEG_1440x1440_Q75",0.3,79,70,90,66,305
"Deity_Earring_with_Vishnu_Garuda_and_chepu_100K","Deity_Earring_with_Vishnu_Garuda_and_chepu_100K_simpL9_qp9_qt7_decompJPEG_512x512_Q50",0.34659090909091,60,6,61,8,135
"Harrison_Front_Parlor_ChairSimplified","Harrison_Front_Parlor_ChairSimplified_simpL9_qp9_qt9_decompJPEG_2048x2048_Q90",0.173076923076922,82,33,63,31,209
"Emberiza_calandra2","Emberiza_calandra2_simpL1_qp8_qt6_decompJPEG_2048x2048_Q10",0.903846153846155,23,29,22,22,96
"ET26_L_MK1","ET26_L_MK1_simpL10_qp11_qt10_decompJPEG_1440x1440_Q90",0.122093023255815,59,2,60,6,127
"SitzenderKnabeNC","SitzenderKnabeNC_simpL9_qp11_qt10_decompJPEG_712x712_Q10",0.420454545454545,91,99,103,84,377
"model_Pastries_20180129_111506950","model_Pastries_20180129_111506950_simpL10_qp10_qt8_decompJPEG_2048x2048_Q25",0.545454545454545,59,45,37,63,204
"Doryphoros_HighRes_4Mfaces_Simplified_BakedUV","Doryphoros_HighRes_4Mfaces_Simplified_BakedUV_simpL6_qp11_qt6_decompJPEG_2048x2048_Q50",0.825581395348838,25,23,26,23,97
"bear","bear_simpL8_qp11_qt7_decompJPEG_1024x1024_Q10",0.272727272727272,84,54,87,70,295
"bronzeCat","bronzeCat_simpL4_qp10_qt7_decompJPEG_2048x2048_Q10",0.625,70,87,91,81,329
"Doryphoros_HighRes_4Mfaces_Simplified_BakedUV","Doryphoros_HighRes_4Mfaces_Simplified_BakedUV_simpL2_qp7_qt8_decompJPEG_2048x2048_Q50",0.988095238095237,25,23,26,23,97
"Emberiza_calandra2","Emberiza_calandra2_simpL8_qp11_qt7_decompJPEG_1440x1440_Q90",0.505681818181817,23,29,22,22,96
"model_Pastries_20180129_111506950","model_Pastries_20180129_111506950_simpL10_qp10_qt7_decompJPEG_2048x2048_Q90",0.727272727272728,59,45,37,63,204
"Emberiza_calandra2","Emberiza_calandra2_simpL10_qp11_qt6_decompJPEG_512x512_Q50",0.5,23,29,22,22,96
"bear","bear_simpL8_qp11_qt9_decompJPEG_712x712_Q25",0.1125,84,54,87,70,295
"ET26_L_MK1","ET26_L_MK1_simpL10_qp9_qt7_decompJPEG_1440x1440_Q75",0.156976744186047,59,2,60,6,127
"ET26_L_MK1","ET26_L_MK1_simpL10_qp8_qt6_decompJPEG_712x712_Q50",0.33888888888889,59,2,60,6,127
"rescue_craft","rescue_craft_simpL9_qp10_qt7_decompJPEG_1440x1440_Q90",0.483333333333333,94,77,72,69,312
"ET26_L_MK1","ET26_L_MK1_simpL1_qp9_qt9_decompJPEG_512x512_Q25",0.380681818181817,59,2,60,6,127
"rescue_craft","rescue_craft_simpL9_qp8_qt10_decompJPEG_712x712_Q10",0.80232558139535,94,77,72,69,312
"Elephant_zun_bakedUV","Elephant_zun_bakedUV_simpL9_qp10_qt8_decompJPEG_2048x2048_Q75",0.273255813953488,79,70,90,66,305
"ET26_L_MK1","ET26_L_MK1_simpL10_qp11_qt6_decompJPEG_1440x1440_Q75",0.29375,59,2,60,6,127
"rescue_craft","rescue_craft_simpL7_qp10_qt8_decompJPEG_712x712_Q90",0.365853658536585,94,77,72,69,312
"Deity_Earring_with_Vishnu_Garuda_and_chepu_100K","Deity_Earring_with_Vishnu_Garuda_and_chepu_100K_simpL9_qp11_qt7_decompJPEG_712x712_Q50",0.2875,60,6,61,8,135
"Emberiza_calandra2","Emberiza_calandra2_simpL10_qp7_qt6_decompJPEG_712x712_Q10",0.71951219512195,23,29,22,22,96
"model_Pastries_20180129_111506950","model_Pastries_20180129_111506950_simpL10_qp10_qt7_decompJPEG_1440x1440_Q90",0.714285714285715,59,45,37,63,204
"bronzeCat","bronzeCat_simpL2_qp10_qt9_decompJPEG_2048x2048_Q10",0.238636363636362,70,87,91,81,329
"rescue_craft","rescue_craft_simpL9_qp10_qt10_decompJPEG_1440x1440_Q25",0.352272727272728,94,77,72,69,312
"Harrison_Front_Parlor_ChairSimplified","Harrison_Front_Parlor_ChairSimplified_simpL4_qp11_qt7_decompJPEG_512x512_Q75",0.8,82,33,63,31,209
"rescue_craft","rescue_craft_simpL9_qp8_qt9_decompJPEG_1024x1024_Q90",0.767045454545455,94,77,72,69,312
"Emberiza_calandra2","Emberiza_calandra2_simpL10_qp11_qt6_decompJPEG_1024x1024_Q50",0.51875,23,29,22,22,96
"bronzeCat","bronzeCat_simpL2_qp10_qt7_decompJPEG_2048x2048_Q50",0.575,70,87,91,81,329
"bear","bear_simpL8_qp10_qt9_decompJPEG_512x512_Q50",0.23170731707317,84,54,87,70,295
"bear","bear_simpL9_qp11_qt10_decompJPEG_512x512_Q75",0.215116279069768,84,54,87,70,295
"SitzenderKnabeNC","SitzenderKnabeNC_simpL3_qp8_qt9_decompJPEG_512x512_Q75",0.633720930232557,91,99,103,84,377
"model_Pastries_20180129_111506950","model_Pastries_20180129_111506950_simpL7_qp11_qt10_decompJPEG_712x712_Q25",0.25,59,45,37,63,204
"Elephant_zun_bakedUV","Elephant_zun_bakedUV_simpL8_qp8_qt10_decompJPEG_1440x1440_Q10",0.45,79,70,90,66,305
"model_Pastries_20180129_111506950","model_Pastries_20180129_111506950_simpL8_qp9_qt10_decompJPEG_712x712_Q25",0.31547619047619,59,45,37,63,204
"model_Pastries_20180129_111506950","model_Pastries_20180129_111506950_simpL6_qp11_qt10_decompJPEG_712x712_Q25",0.25,59,45,37,63,204
"Harrison_Front_Parlor_ChairSimplified","Harrison_Front_Parlor_ChairSimplified_simpL9_qp10_qt7_decompJPEG_512x512_Q75",0.76875,82,33,63,31,209
"Deity_Earring_with_Vishnu_Garuda_and_chepu_100K","Deity_Earring_with_Vishnu_Garuda_and_chepu_100K_simpL7_qp8_qt7_decompJPEG_1024x1024_Q90",0.48125,60,6,61,8,135
"ET26_L_MK1","ET26_L_MK1_simpL3_qp10_qt10_decompJPEG_512x512_Q25",0.151162790697675,59,2,60,6,127
"bronzeCat","bronzeCat_simpL1_qp10_qt9_decompJPEG_1440x1440_Q50",0.15340909090909,70,87,91,81,329
"rescue_craft","rescue_craft_simpL8_qp11_qt10_decompJPEG_512x512_Q25",0.319767441860465,94,77,72,69,312
"ET26_L_MK1","ET26_L_MK1_simpL2_qp9_qt8_decompJPEG_512x512_Q90",0.345238095238095,59,2,60,6,127
"bronzeCat","bronzeCat_simpL10_qp8_qt8_decompJPEG_2048x2048_Q90",0.55,70,87,91,81,329
"bronzeCat","bronzeCat_simpL10_qp8_qt9_decompJPEG_2048x2048_Q25",0.563953488372092,70,87,91,81,329
"Emberiza_calandra2","Emberiza_calandra2_simpL8_qp8_qt8_decompJPEG_512x512_Q50",0.545454545454545,23,29,22,22,96
"bear","bear_simpL10_qp7_qt10_decompJPEG_2048x2048_Q75",0.71590909090909,84,54,87,70,295
"bronzeCat","bronzeCat_simpL8_qp10_qt7_decompJPEG_1440x1440_Q50",0.426136363636363,70,87,91,81,329
"SitzenderKnabeNC","SitzenderKnabeNC_simpL7_qp11_qt8_decompJPEG_712x712_Q10",0.3125,91,99,103,84,377
"rescue_craft","rescue_craft_simpL2_qp10_qt8_decompJPEG_712x712_Q50",0.33888888888889,94,77,72,69,312
"Elephant_zun_bakedUV","Elephant_zun_bakedUV_simpL8_qp8_qt9_decompJPEG_1440x1440_Q10",0.53048780487805,79,70,90,66,305
"Elephant_zun_bakedUV","Elephant_zun_bakedUV_simpL9_qp11_qt7_decompJPEG_2048x2048_Q75",0.4625,79,70,90,66,305
"ET26_L_MK1","ET26_L_MK1_simpL1_qp10_qt8_decompJPEG_712x712_Q25",0.23170731707317,59,2,60,6,127
"rescue_craft","rescue_craft_simpL9_qp10_qt8_decompJPEG_512x512_Q25",0.46590909090909,94,77,72,69,312
"Elephant_zun_bakedUV","Elephant_zun_bakedUV_simpL9_qp11_qt10_decompJPEG_2048x2048_Q50",0.186046511627908,79,70,90,66,305
"SitzenderKnabeNC","SitzenderKnabeNC_simpL3_qp10_qt10_decompJPEG_1440x1440_Q10",0.158536585365852,91,99,103,84,377
"model_Pastries_20180129_111506950","model_Pastries_20180129_111506950_simpL10_qp11_qt6_decompJPEG_2048x2048_Q50",0.914772727272728,59,45,37,63,204
"Doryphoros_HighRes_4Mfaces_Simplified_BakedUV","Doryphoros_HighRes_4Mfaces_Simplified_BakedUV_simpL6_qp10_qt6_decompJPEG_712x712_Q25",0.790697674418605,25,23,26,23,97
"Doryphoros_HighRes_4Mfaces_Simplified_BakedUV","Doryphoros_HighRes_4Mfaces_Simplified_BakedUV_simpL8_qp7_qt6_decompJPEG_2048x2048_Q50",1,25,23,26,23,97
"Emberiza_calandra2","Emberiza_calandra2_simpL7_qp8_qt8_decompJPEG_512x512_Q75",0.529761904761905,23,29,22,22,96
"Elephant_zun_bakedUV","Elephant_zun_bakedUV_simpL9_qp9_qt8_decompJPEG_1440x1440_Q25",0.33139534883721,79,70,90,66,305
"Emberiza_calandra2","Emberiza_calandra2_simpL6_qp8_qt9_decompJPEG_712x712_Q75",0.546511627906977,23,29,22,22,96
"Harrison_Front_Parlor_ChairSimplified","Harrison_Front_Parlor_ChairSimplified_simpL3_qp9_qt10_decompJPEG_1024x1024_Q90",0.301136363636363,82,33,63,31,209
"Emberiza_calandra2","Emberiza_calandra2_simpL8_qp8_qt8_decompJPEG_1024x1024_Q50",0.52840909090909,23,29,22,22,96
"Emberiza_calandra2","Emberiza_calandra2_simpL1_qp8_qt6_decompJPEG_2048x2048_Q25",0.94767441860465,23,29,22,22,96
"Emberiza_calandra2","Emberiza_calandra2_simpL10_qp7_qt7_decompJPEG_712x712_Q10",0.573170731707317,23,29,22,22,96
"rescue_craft","rescue_craft_simpL1_qp11_qt6_decompJPEG_712x712_Q50",0.566666666666668,94,77,72,69,312
"bronzeCat","bronzeCat_simpL2_qp10_qt9_decompJPEG_1024x1024_Q10",0.4,70,87,91,81,329
"Doryphoros_HighRes_4Mfaces_Simplified_BakedUV","Doryphoros_HighRes_4Mfaces_Simplified_BakedUV_simpL1_qp9_qt8_decompJPEG_1024x1024_Q10",0.806818181818183,25,23,26,23,97
"Harrison_Front_Parlor_ChairSimplified","Harrison_Front_Parlor_ChairSimplified_simpL1_qp10_qt10_decompJPEG_1024x1024_Q90",0.204545454545455,82,33,63,31,209
"Harrison_Front_Parlor_ChairSimplified","Harrison_Front_Parlor_ChairSimplified_simpL7_qp10_qt9_decompJPEG_712x712_Q90",0.226744186046512,82,33,63,31,209
"Doryphoros_HighRes_4Mfaces_Simplified_BakedUV","Doryphoros_HighRes_4Mfaces_Simplified_BakedUV_simpL4_qp10_qt6_decompJPEG_1440x1440_Q75",0.825,25,23,26,23,97
"bear","bear_simpL2_qp8_qt6_decompJPEG_512x512_Q25",0.895348837209302,84,54,87,70,295
"model_Pastries_20180129_111506950","model_Pastries_20180129_111506950_simpL3_qp8_qt9_decompJPEG_1440x1440_Q25",0.432926829268293,59,45,37,63,204
"SitzenderKnabeNC","SitzenderKnabeNC_simpL5_qp11_qt10_decompJPEG_512x512_Q10",0.366279069767443,91,99,103,84,377
"Deity_Earring_with_Vishnu_Garuda_and_chepu_100K","Deity_Earring_with_Vishnu_Garuda_and_chepu_100K_simpL9_qp8_qt6_decompJPEG_1440x1440_Q10",0.686046511627908,60,6,61,8,135
"Doryphoros_HighRes_4Mfaces_Simplified_BakedUV","Doryphoros_HighRes_4Mfaces_Simplified_BakedUV_simpL8_qp9_qt6_decompJPEG_2048x2048_Q25",0.843023255813953,25,23,26,23,97
"bear","bear_simpL9_qp10_qt8_decompJPEG_712x712_Q75",0.21590909090909,84,54,87,70,295
"rescue_craft","rescue_craft_simpL5_qp11_qt10_decompJPEG_712x712_Q10",0.186046511627908,94,77,72,69,312
"ET26_L_MK1","ET26_L_MK1_simpL10_qp8_qt7_decompJPEG_2048x2048_Q75",0.23125,59,2,60,6,127
"model_Pastries_20180129_111506950","model_Pastries_20180129_111506950_simpL10_qp10_qt7_decompJPEG_1440x1440_Q50",0.789772727272728,59,45,37,63,204
"Elephant_zun_bakedUV","Elephant_zun_bakedUV_simpL9_qp9_qt10_decompJPEG_2048x2048_Q75",0.255813953488373,79,70,90,66,305
"rescue_craft","rescue_craft_simpL8_qp10_qt8_decompJPEG_2048x2048_Q25",0.354651162790698,94,77,72,69,312
"Doryphoros_HighRes_4Mfaces_Simplified_BakedUV","Doryphoros_HighRes_4Mfaces_Simplified_BakedUV_simpL1_qp10_qt8_decompJPEG_2048x2048_Q10",0.541666666666668,25,23,26,23,97
"Emberiza_calandra2","Emberiza_calandra2_simpL10_qp10_qt6_decompJPEG_2048x2048_Q50",0.51875,23,29,22,22,96
"bear","bear_simpL8_qp10_qt10_decompJPEG_512x512_Q75",0.164772727272728,84,54,87,70,295
"Harrison_Front_Parlor_ChairSimplified","Harrison_Front_Parlor_ChairSimplified_simpL6_qp11_qt7_decompJPEG_512x512_Q75",0.801136363636362,82,33,63,31,209
"bear","bear_simpL5_qp9_qt9_decompJPEG_712x712_Q10",0.488636363636363,84,54,87,70,295
"SitzenderKnabeNC","SitzenderKnabeNC_simpL1_qp10_qt7_decompJPEG_2048x2048_Q50",0.41860465116279,91,99,103,84,377
"Harrison_Front_Parlor_ChairSimplified","Harrison_Front_Parlor_ChairSimplified_simpL3_qp9_qt10_decompJPEG_1440x1440_Q90",0.343023255813953,82,33,63,31,209
"Emberiza_calandra2","Emberiza_calandra2_simpL3_qp8_qt6_decompJPEG_1440x1440_Q10",0.872222222222222,23,29,22,22,96
"SitzenderKnabeNC","SitzenderKnabeNC_simpL9_qp11_qt6_decompJPEG_712x712_Q90",0.654761904761905,91,99,103,84,377
"bear","bear_simpL5_qp11_qt10_decompJPEG_512x512_Q25",0.203488372093023,84,54,87,70,295
"ET26_L_MK1","ET26_L_MK1_simpL10_qp8_qt7_decompJPEG_1440x1440_Q75",0.24404761904762,59,2,60,6,127
"ET26_L_MK1","ET26_L_MK1_simpL1_qp9_qt8_decompJPEG_512x512_Q25",0.392857142857142,59,2,60,6,127
"bear","bear_simpL9_qp11_qt9_decompJPEG_512x512_Q75",0.232954545454545,84,54,87,70,295
"Doryphoros_HighRes_4Mfaces_Simplified_BakedUV","Doryphoros_HighRes_4Mfaces_Simplified_BakedUV_simpL1_qp9_qt10_decompJPEG_2048x2048_Q10",0.6875,25,23,26,23,97
"bronzeCat","bronzeCat_simpL8_qp9_qt9_decompJPEG_712x712_Q25",0.304878048780488,70,87,91,81,329
"Doryphoros_HighRes_4Mfaces_Simplified_BakedUV","Doryphoros_HighRes_4Mfaces_Simplified_BakedUV_simpL7_qp8_qt6_decompJPEG_2048x2048_Q10",0.982558139534883,25,23,26,23,97
"rescue_craft","rescue_craft_simpL9_qp10_qt7_decompJPEG_2048x2048_Q25",0.460227272727272,94,77,72,69,312
"SitzenderKnabeNC","SitzenderKnabeNC_simpL5_qp11_qt10_decompJPEG_712x712_Q10",0.30952380952381,91,99,103,84,377
"bear","bear_simpL8_qp9_qt9_decompJPEG_1024x1024_Q75",0.22560975609756,84,54,87,70,295
"bear","bear_simpL9_qp9_qt9_decompJPEG_2048x2048_Q75",0.170454545454545,84,54,87,70,295
"bear","bear_simpL9_qp10_qt8_decompJPEG_712x712_Q25",0.178571428571427,84,54,87,70,295
"Harrison_Front_Parlor_ChairSimplified","Harrison_Front_Parlor_ChairSimplified_simpL8_qp9_qt10_decompJPEG_1024x1024_Q50",0.339285714285715,82,33,63,31,209
"Deity_Earring_with_Vishnu_Garuda_and_chepu_100K","Deity_Earring_with_Vishnu_Garuda_and_chepu_100K_simpL4_qp9_qt10_decompJPEG_712x712_Q10",0.147727272727272,60,6,61,8,135
"bronzeCat","bronzeCat_simpL8_qp11_qt10_decompJPEG_512x512_Q75",0.193181818181817,70,87,91,81,329
"bronzeCat","bronzeCat_simpL10_qp8_qt8_decompJPEG_2048x2048_Q25",0.55952380952381,70,87,91,81,329
"model_Pastries_20180129_111506950","model_Pastries_20180129_111506950_simpL10_qp10_qt8_decompJPEG_2048x2048_Q75",0.56875,59,45,37,63,204
"ET26_L_MK1","ET26_L_MK1_simpL2_qp9_qt9_decompJPEG_512x512_Q25",0.319767441860465,59,2,60,6,127
"Deity_Earring_with_Vishnu_Garuda_and_chepu_100K","Deity_Earring_with_Vishnu_Garuda_and_chepu_100K_simpL9_qp7_qt9_decompJPEG_1024x1024_Q10",0.511363636363637,60,6,61,8,135
"SitzenderKnabeNC","SitzenderKnabeNC_simpL9_qp8_qt7_decompJPEG_712x712_Q50",0.546511627906977,91,99,103,84,377
"bronzeCat","bronzeCat_simpL6_qp9_qt10_decompJPEG_712x712_Q90",0.488372093023255,70,87,91,81,329
"bear","bear_simpL8_qp11_qt10_decompJPEG_512x512_Q75",0.182926829268292,84,54,87,70,295
"Doryphoros_HighRes_4Mfaces_Simplified_BakedUV","Doryphoros_HighRes_4Mfaces_Simplified_BakedUV_simpL1_qp11_qt9_decompJPEG_712x712_Q75",0.255681818181817,25,23,26,23,97
"bear","bear_simpL9_qp8_qt9_decompJPEG_512x512_Q10",0.767857142857143,84,54,87,70,295
"Emberiza_calandra2","Emberiza_calandra2_simpL10_qp11_qt6_decompJPEG_512x512_Q90",0.488636363636363,23,29,22,22,96
"bear","bear_simpL10_qp11_qt10_decompJPEG_1440x1440_Q50",0.738095238095237,84,54,87,70,295
"Harrison_Front_Parlor_ChairSimplified","Harrison_Front_Parlor_ChairSimplified_simpL9_qp11_qt7_decompJPEG_512x512_Q90",0.73888888888889,82,33,63,31,209
"ET26_L_MK1","ET26_L_MK1_simpL10_qp8_qt6_decompJPEG_1440x1440_Q25",0.38125,59,2,60,6,127
"Harrison_Front_Parlor_ChairSimplified","Harrison_Front_Parlor_ChairSimplified_simpL7_qp11_qt6_decompJPEG_712x712_Q50",0.791666666666668,82,33,63,31,209
"bear","bear_simpL6_qp9_qt7_decompJPEG_2048x2048_Q75",0.488372093023255,84,54,87,70,295
"Harrison_Front_Parlor_ChairSimplified","Harrison_Front_Parlor_ChairSimplified_simpL9_qp11_qt8_decompJPEG_2048x2048_Q90",0.26829268292683,82,33,63,31,209
"ET26_L_MK1","ET26_L_MK1_simpL10_qp8_qt7_decompJPEG_712x712_Q75",0.1875,59,2,60,6,127
"Elephant_zun_bakedUV","Elephant_zun_bakedUV_simpL7_qp10_qt10_decompJPEG_512x512_Q90",0.301136363636363,79,70,90,66,305
"bear","bear_simpL5_qp9_qt9_decompJPEG_1440x1440_Q10",0.476744186046512,84,54,87,70,295
"Doryphoros_HighRes_4Mfaces_Simplified_BakedUV","Doryphoros_HighRes_4Mfaces_Simplified_BakedUV_simpL1_qp9_qt9_decompJPEG_712x712_Q10",0.790697674418605,25,23,26,23,97
"ET26_L_MK1","ET26_L_MK1_simpL10_qp11_qt6_decompJPEG_712x712_Q75",0.244444444444445,59,2,60,6,127
"Emberiza_calandra2","Emberiza_calandra2_simpL10_qp8_qt7_decompJPEG_1440x1440_Q75",0.477777777777778,23,29,22,22,96
"bronzeCat","bronzeCat_simpL9_qp10_qt7_decompJPEG_1440x1440_Q90",0.422619047619047,70,87,91,81,329
"Doryphoros_HighRes_4Mfaces_Simplified_BakedUV","Doryphoros_HighRes_4Mfaces_Simplified_BakedUV_simpL7_qp9_qt6_decompJPEG_1440x1440_Q10",0.880681818181817,25,23,26,23,97
"ET26_L_MK1","ET26_L_MK1_simpL10_qp10_qt6_decompJPEG_1440x1440_Q90",0.267441860465118,59,2,60,6,127
"Harrison_Front_Parlor_ChairSimplified","Harrison_Front_Parlor_ChairSimplified_simpL1_qp10_qt10_decompJPEG_1440x1440_Q75",0.142857142857143,82,33,63,31,209
"ET26_L_MK1","ET26_L_MK1_simpL3_qp9_qt10_decompJPEG_512x512_Q25",0.255813953488373,59,2,60,6,127
"rescue_craft","rescue_craft_simpL9_qp10_qt7_decompJPEG_1024x1024_Q75",0.522222222222222,94,77,72,69,312
"SitzenderKnabeNC","SitzenderKnabeNC_simpL10_qp10_qt6_decompJPEG_2048x2048_Q25",0.84090909090909,91,99,103,84,377
"bronzeCat","bronzeCat_simpL3_qp8_qt7_decompJPEG_1440x1440_Q75",0.875,70,87,91,81,329
"model_Pastries_20180129_111506950","model_Pastries_20180129_111506950_simpL8_qp11_qt10_decompJPEG_712x712_Q25",0.27906976744186,59,45,37,63,204
"Deity_Earring_with_Vishnu_Garuda_and_chepu_100K","Deity_Earring_with_Vishnu_Garuda_and_chepu_100K_simpL3_qp8_qt9_decompJPEG_512x512_Q10",0.424418604651163,60,6,61,8,135
"Doryphoros_HighRes_4Mfaces_Simplified_BakedUV","Doryphoros_HighRes_4Mfaces_Simplified_BakedUV_simpL6_qp9_qt6_decompJPEG_1440x1440_Q25",0.843023255813953,25,23,26,23,97
"Doryphoros_HighRes_4Mfaces_Simplified_BakedUV","Doryphoros_HighRes_4Mfaces_Simplified_BakedUV_simpL9_qp11_qt6_decompJPEG_512x512_Q90",0.75,25,23,26,23,97
"Emberiza_calandra2","Emberiza_calandra2_simpL10_qp11_qt6_decompJPEG_712x712_Q50",0.53125,23,29,22,22,96
"rescue_craft","rescue_craft_simpL7_qp9_qt7_decompJPEG_2048x2048_Q90",0.63125,94,77,72,69,312
"Doryphoros_HighRes_4Mfaces_Simplified_BakedUV","Doryphoros_HighRes_4Mfaces_Simplified_BakedUV_simpL2_qp10_qt6_decompJPEG_2048x2048_Q75",0.857954545454545,25,23,26,23,97
"Elephant_zun_bakedUV","Elephant_zun_bakedUV_simpL8_qp9_qt8_decompJPEG_2048x2048_Q50",0.272727272727272,79,70,90,66,305
"bronzeCat","bronzeCat_simpL10_qp10_qt8_decompJPEG_2048x2048_Q50",0.505813953488373,70,87,91,81,329
"bronzeCat","bronzeCat_simpL1_qp10_qt8_decompJPEG_512x512_Q90",0.176829268292682,70,87,91,81,329
"Doryphoros_HighRes_4Mfaces_Simplified_BakedUV","Doryphoros_HighRes_4Mfaces_Simplified_BakedUV_simpL9_qp8_qt6_decompJPEG_2048x2048_Q75",0.93452380952381,25,23,26,23,97
"bronzeCat","bronzeCat_simpL10_qp8_qt8_decompJPEG_1024x1024_Q75",0.516666666666667,70,87,91,81,329
"Doryphoros_HighRes_4Mfaces_Simplified_BakedUV","Doryphoros_HighRes_4Mfaces_Simplified_BakedUV_simpL1_qp10_qt6_decompJPEG_1440x1440_Q10",0.866279069767443,25,23,26,23,97
"bear","bear_simpL6_qp10_qt10_decompJPEG_512x512_Q10",0.18452380952381,84,54,87,70,295
"ET26_L_MK1","ET26_L_MK1_simpL10_qp9_qt7_decompJPEG_1024x1024_Q50",0.25,59,2,60,6,127
"Deity_Earring_with_Vishnu_Garuda_and_chepu_100K","Deity_Earring_with_Vishnu_Garuda_and_chepu_100K_simpL5_qp9_qt9_decompJPEG_712x712_Q10",0.140243902439025,60,6,61,8,135
"Emberiza_calandra2","Emberiza_calandra2_simpL5_qp8_qt9_decompJPEG_712x712_Q10",0.672619047619047,23,29,22,22,96
"Doryphoros_HighRes_4Mfaces_Simplified_BakedUV","Doryphoros_HighRes_4Mfaces_Simplified_BakedUV_simpL5_qp9_qt6_decompJPEG_1440x1440_Q75",0.886904761904763,25,23,26,23,97
"Harrison_Front_Parlor_ChairSimplified","Harrison_Front_Parlor_ChairSimplified_simpL2_qp11_qt10_decompJPEG_2048x2048_Q90",0.125,82,33,63,31,209
"Emberiza_calandra2","Emberiza_calandra2_simpL10_qp8_qt7_decompJPEG_1440x1440_Q90",0.347560975609755,23,29,22,22,96
"bronzeCat","bronzeCat_simpL7_qp9_qt10_decompJPEG_512x512_Q90",0.47093023255814,70,87,91,81,329
"bronzeCat","bronzeCat_simpL5_qp11_qt9_decompJPEG_2048x2048_Q10",0.156976744186047,70,87,91,81,329
"ET26_L_MK1","ET26_L_MK1_simpL10_qp11_qt6_decompJPEG_1440x1440_Q50",0.30952380952381,59,2,60,6,127
"bronzeCat","bronzeCat_simpL3_qp10_qt8_decompJPEG_2048x2048_Q50",0.238095238095237,70,87,91,81,329
"SitzenderKnabeNC","SitzenderKnabeNC_simpL4_qp11_qt8_decompJPEG_1024x1024_Q10",0.174418604651162,91,99,103,84,377
"model_Pastries_20180129_111506950","model_Pastries_20180129_111506950_simpL10_qp9_qt8_decompJPEG_1024x1024_Q90",0.613095238095237,59,45,37,63,204
"ET26_L_MK1","ET26_L_MK1_simpL10_qp11_qt7_decompJPEG_1440x1440_Q90",0.261904761904763,59,2,60,6,127
"model_Pastries_20180129_111506950","model_Pastries_20180129_111506950_simpL10_qp10_qt7_decompJPEG_1440x1440_Q10",0.720238095238095,59,45,37,63,204
"bronzeCat","bronzeCat_simpL6_qp9_qt9_decompJPEG_2048x2048_Q90",0.386363636363637,70,87,91,81,329
"Deity_Earring_with_Vishnu_Garuda_and_chepu_100K","Deity_Earring_with_Vishnu_Garuda_and_chepu_100K_simpL5_qp11_qt7_decompJPEG_712x712_Q10",0.284883720930233,60,6,61,8,135
"Deity_Earring_with_Vishnu_Garuda_and_chepu_100K","Deity_Earring_with_Vishnu_Garuda_and_chepu_100K_simpL9_qp10_qt6_decompJPEG_512x512_Q50",0.577777777777778,60,6,61,8,135
"Harrison_Front_Parlor_ChairSimplified","Harrison_Front_Parlor_ChairSimplified_simpL3_qp9_qt10_decompJPEG_1440x1440_Q50",0.34659090909091,82,33,63,31,209
"Emberiza_calandra2","Emberiza_calandra2_simpL10_qp10_qt6_decompJPEG_512x512_Q90",0.465116279069767,23,29,22,22,96
"bear","bear_simpL10_qp7_qt10_decompJPEG_1024x1024_Q75",0.71951219512195,84,54,87,70,295
"ET26_L_MK1","ET26_L_MK1_simpL10_qp10_qt7_decompJPEG_1440x1440_Q75",0.210526315789473,59,2,60,6,127
"Deity_Earring_with_Vishnu_Garuda_and_chepu_100K","Deity_Earring_with_Vishnu_Garuda_and_chepu_100K_simpL2_qp8_qt9_decompJPEG_512x512_Q10",0.477272727272728,60,6,61,8,135
"Deity_Earring_with_Vishnu_Garuda_and_chepu_100K","Deity_Earring_with_Vishnu_Garuda_and_chepu_100K_simpL9_qp10_qt6_decompJPEG_1440x1440_Q10",0.585227272727272,60,6,61,8,135
"Elephant_zun_bakedUV","Elephant_zun_bakedUV_simpL9_qp11_qt7_decompJPEG_1440x1440_Q90",0.459302325581395,79,70,90,66,305
"SitzenderKnabeNC","SitzenderKnabeNC_simpL1_qp11_qt7_decompJPEG_1440x1440_Q25",0.39375,91,99,103,84,377
"model_Pastries_20180129_111506950","model_Pastries_20180129_111506950_simpL10_qp10_qt7_decompJPEG_1440x1440_Q75",0.715116279069767,59,45,37,63,204
"Emberiza_calandra2","Emberiza_calandra2_simpL10_qp7_qt6_decompJPEG_1024x1024_Q75",0.575581395348837,23,29,22,22,96
"Deity_Earring_with_Vishnu_Garuda_and_chepu_100K","Deity_Earring_with_Vishnu_Garuda_and_chepu_100K_simpL9_qp9_qt6_decompJPEG_2048x2048_Q25",0.66875,60,6,61,8,135
"rescue_craft","rescue_craft_simpL6_qp10_qt10_decompJPEG_1440x1440_Q50",0.24404761904762,94,77,72,69,312
"Elephant_zun_bakedUV","Elephant_zun_bakedUV_simpL5_qp10_qt8_decompJPEG_512x512_Q90",0.23125,79,70,90,66,305
"Harrison_Front_Parlor_ChairSimplified","Harrison_Front_Parlor_ChairSimplified_simpL7_qp11_qt7_decompJPEG_512x512_Q90",0.755681818181817,82,33,63,31,209
"model_Pastries_20180129_111506950","model_Pastries_20180129_111506950_simpL1_qp8_qt9_decompJPEG_712x712_Q25",0.488372093023255,59,45,37,63,204
"model_Pastries_20180129_111506950","model_Pastries_20180129_111506950_simpL10_qp11_qt8_decompJPEG_1440x1440_Q10",0.576923076923078,59,45,37,63,204
"bronzeCat","bronzeCat_simpL1_qp11_qt9_decompJPEG_712x712_Q90",0.0769230769230775,70,87,91,81,329
"Deity_Earring_with_Vishnu_Garuda_and_chepu_100K","Deity_Earring_with_Vishnu_Garuda_and_chepu_100K_simpL9_qp8_qt8_decompJPEG_512x512_Q50",0.318181818181817,60,6,61,8,135
"rescue_craft","rescue_craft_simpL9_qp10_qt6_decompJPEG_1024x1024_Q50",0.69047619047619,94,77,72,69,312
"Harrison_Front_Parlor_ChairSimplified","Harrison_Front_Parlor_ChairSimplified_simpL2_qp11_qt8_decompJPEG_1024x1024_Q75",0.726744186046512,82,33,63,31,209
"Deity_Earring_with_Vishnu_Garuda_and_chepu_100K","Deity_Earring_with_Vishnu_Garuda_and_chepu_100K_simpL9_qp8_qt6_decompJPEG_712x712_Q25",0.633720930232557,60,6,61,8,135
"model_Pastries_20180129_111506950","model_Pastries_20180129_111506950_simpL10_qp10_qt7_decompJPEG_2048x2048_Q50",0.69186046511628,59,45,37,63,204
"Doryphoros_HighRes_4Mfaces_Simplified_BakedUV","Doryphoros_HighRes_4Mfaces_Simplified_BakedUV_simpL5_qp11_qt6_decompJPEG_2048x2048_Q90",0.78888888888889,25,23,26,23,97
"bear","bear_simpL3_qp7_qt6_decompJPEG_1024x1024_Q25",0.988095238095237,84,54,87,70,295
"Harrison_Front_Parlor_ChairSimplified","Harrison_Front_Parlor_ChairSimplified_simpL9_qp10_qt9_decompJPEG_2048x2048_Q75",0.0813953488372099,82,33,63,31,209
"SitzenderKnabeNC","SitzenderKnabeNC_simpL6_qp8_qt9_decompJPEG_2048x2048_Q75",0.51829268292683,91,99,103,84,377
"SitzenderKnabeNC","SitzenderKnabeNC_simpL6_qp11_qt10_decompJPEG_1440x1440_Q10",0.196428571428573,91,99,103,84,377
"Harrison_Front_Parlor_ChairSimplified","Harrison_Front_Parlor_ChairSimplified_simpL3_qp11_qt8_decompJPEG_512x512_Q90",0.656976744186047,82,33,63,31,209
"bear","bear_simpL8_qp9_qt9_decompJPEG_1024x1024_Q90",0.284883720930233,84,54,87,70,295
"model_Pastries_20180129_111506950","model_Pastries_20180129_111506950_simpL1_qp8_qt10_decompJPEG_512x512_Q75",0.55952380952381,59,45,37,63,204
"SitzenderKnabeNC","SitzenderKnabeNC_simpL10_qp11_qt6_decompJPEG_1440x1440_Q25",0.796511627906977,91,99,103,84,377
"Elephant_zun_bakedUV","Elephant_zun_bakedUV_simpL9_qp11_qt10_decompJPEG_1440x1440_Q90",0.166666666666667,79,70,90,66,305
"Emberiza_calandra2","Emberiza_calandra2_simpL10_qp8_qt6_decompJPEG_1440x1440_Q10",0.539772727272728,23,29,22,22,96
"SitzenderKnabeNC","SitzenderKnabeNC_simpL10_qp8_qt8_decompJPEG_712x712_Q75",0.775,91,99,103,84,377
"Doryphoros_HighRes_4Mfaces_Simplified_BakedUV","Doryphoros_HighRes_4Mfaces_Simplified_BakedUV_simpL4_qp7_qt6_decompJPEG_512x512_Q50",0.982954545454545,25,23,26,23,97
"Harrison_Front_Parlor_ChairSimplified","Harrison_Front_Parlor_ChairSimplified_simpL2_qp11_qt9_decompJPEG_2048x2048_Q50",0.377906976744185,82,33,63,31,209
"Elephant_zun_bakedUV","Elephant_zun_bakedUV_simpL9_qp10_qt8_decompJPEG_2048x2048_Q90",0.333333333333332,79,70,90,66,305
"ET26_L_MK1","ET26_L_MK1_simpL10_qp8_qt6_decompJPEG_512x512_Q75",0.290697674418605,59,2,60,6,127
"SitzenderKnabeNC","SitzenderKnabeNC_simpL6_qp9_qt6_decompJPEG_712x712_Q50",0.494318181818183,91,99,103,84,377
"Deity_Earring_with_Vishnu_Garuda_and_chepu_100K","Deity_Earring_with_Vishnu_Garuda_and_chepu_100K_simpL4_qp8_qt9_decompJPEG_512x512_Q25",0.348837209302325,60,6,61,8,135
"Deity_Earring_with_Vishnu_Garuda_and_chepu_100K","Deity_Earring_with_Vishnu_Garuda_and_chepu_100K_simpL6_qp8_qt8_decompJPEG_512x512_Q10",0.458333333333332,60,6,61,8,135
"Doryphoros_HighRes_4Mfaces_Simplified_BakedUV","Doryphoros_HighRes_4Mfaces_Simplified_BakedUV_simpL4_qp9_qt6_decompJPEG_512x512_Q90",0.865853658536585,25,23,26,23,97
"Elephant_zun_bakedUV","Elephant_zun_bakedUV_simpL9_qp11_qt8_decompJPEG_1440x1440_Q90",0.296511627906977,79,70,90,66,305
"SitzenderKnabeNC","SitzenderKnabeNC_simpL3_qp11_qt10_decompJPEG_1440x1440_Q25",0.13095238095238,91,99,103,84,377
"ET26_L_MK1","ET26_L_MK1_simpL4_qp9_qt9_decompJPEG_512x512_Q25",0.323863636363637,59,2,60,6,127
"model_Pastries_20180129_111506950","model_Pastries_20180129_111506950_simpL10_qp10_qt6_decompJPEG_2048x2048_Q75",0.825581395348838,59,45,37,63,204
"Harrison_Front_Parlor_ChairSimplified","Harrison_Front_Parlor_ChairSimplified_simpL7_qp11_qt8_decompJPEG_512x512_Q10",0.715116279069767,82,33,63,31,209
"rescue_craft","rescue_craft_simpL9_qp10_qt8_decompJPEG_512x512_Q50",0.43452380952381,94,77,72,69,312
"Elephant_zun_bakedUV","Elephant_zun_bakedUV_simpL9_qp11_qt8_decompJPEG_2048x2048_Q50",0.25,79,70,90,66,305
"bronzeCat","bronzeCat_simpL10_qp9_qt8_decompJPEG_2048x2048_Q25",0.575581395348837,70,87,91,81,329
"ET26_L_MK1","ET26_L_MK1_simpL1_qp10_qt9_decompJPEG_512x512_Q25",0.202380952380953,59,2,60,6,127
"SitzenderKnabeNC","SitzenderKnabeNC_simpL6_qp11_qt9_decompJPEG_1024x1024_Q10",0.213414634146343,91,99,103,84,377
"ET26_L_MK1","ET26_L_MK1_simpL10_qp8_qt6_decompJPEG_2048x2048_Q50",0.36904761904762,59,2,60,6,127
"Deity_Earring_with_Vishnu_Garuda_and_chepu_100K","Deity_Earring_with_Vishnu_Garuda_and_chepu_100K_simpL9_qp7_qt10_decompJPEG_1024x1024_Q50",0.517857142857142,60,6,61,8,135
"Emberiza_calandra2","Emberiza_calandra2_simpL7_qp10_qt8_decompJPEG_712x712_Q75",0.19047619047619,23,29,22,22,96
"Elephant_zun_bakedUV","Elephant_zun_bakedUV_simpL6_qp11_qt10_decompJPEG_512x512_Q90",0.25595238095238,79,70,90,66,305
"bear","bear_simpL7_qp9_qt9_decompJPEG_512x512_Q10",0.40909090909091,84,54,87,70,295
"Elephant_zun_bakedUV","Elephant_zun_bakedUV_simpL9_qp9_qt7_decompJPEG_2048x2048_Q50",0.448863636363637,79,70,90,66,305
"SitzenderKnabeNC","SitzenderKnabeNC_simpL3_qp10_qt7_decompJPEG_1440x1440_Q75",0.431818181818183,91,99,103,84,377
"SitzenderKnabeNC","SitzenderKnabeNC_simpL5_qp11_qt9_decompJPEG_1024x1024_Q10",0.226190476190478,91,99,103,84,377
"ET26_L_MK1","ET26_L_MK1_simpL10_qp9_qt9_decompJPEG_1024x1024_Q50",0.203488372093023,59,2,60,6,127
"Elephant_zun_bakedUV","Elephant_zun_bakedUV_simpL9_qp9_qt8_decompJPEG_1440x1440_Q90",0.273255813953488,79,70,90,66,305
"bear","bear_simpL8_qp11_qt10_decompJPEG_512x512_Q50",0.203488372093023,84,54,87,70,295
"Doryphoros_HighRes_4Mfaces_Simplified_BakedUV","Doryphoros_HighRes_4Mfaces_Simplified_BakedUV_simpL1_qp10_qt8_decompJPEG_1440x1440_Q10",0.517857142857142,25,23,26,23,97
"SitzenderKnabeNC","SitzenderKnabeNC_simpL8_qp7_qt6_decompJPEG_512x512_Q50",0.916666666666668,91,99,103,84,377
"Emberiza_calandra2","Emberiza_calandra2_simpL10_qp10_qt7_decompJPEG_1024x1024_Q25",0.397727272727272,23,29,22,22,96
"Deity_Earring_with_Vishnu_Garuda_and_chepu_100K","Deity_Earring_with_Vishnu_Garuda_and_chepu_100K_simpL9_qp11_qt6_decompJPEG_1440x1440_Q75",0.593023255813953,60,6,61,8,135
"rescue_craft","rescue_craft_simpL1_qp10_qt7_decompJPEG_2048x2048_Q25",0.44047619047619,94,77,72,69,312
"bear","bear_simpL7_qp9_qt10_decompJPEG_512x512_Q75",0.406976744186047,84,54,87,70,295
"model_Pastries_20180129_111506950","model_Pastries_20180129_111506950_simpL10_qp10_qt6_decompJPEG_1024x1024_Q75",0.813953488372092,59,45,37,63,204
"Emberiza_calandra2","Emberiza_calandra2_simpL10_qp8_qt7_decompJPEG_1440x1440_Q50",0.410714285714285,23,29,22,22,96
"SitzenderKnabeNC","SitzenderKnabeNC_simpL8_qp9_qt9_decompJPEG_512x512_Q25",0.352272727272728,91,99,103,84,377
"SitzenderKnabeNC","SitzenderKnabeNC_simpL1_qp10_qt7_decompJPEG_1440x1440_Q50",0.41860465116279,91,99,103,84,377
"rescue_craft","rescue_craft_simpL6_qp11_qt10_decompJPEG_712x712_Q10",0.25,94,77,72,69,312
"rescue_craft","rescue_craft_simpL9_qp8_qt10_decompJPEG_1024x1024_Q10",0.823863636363638,94,77,72,69,312
"Harrison_Front_Parlor_ChairSimplified","Harrison_Front_Parlor_ChairSimplified_simpL1_qp11_qt9_decompJPEG_2048x2048_Q75",0.28125,82,33,63,31,209
"Emberiza_calandra2","Emberiza_calandra2_simpL10_qp7_qt6_decompJPEG_712x712_Q25",0.702380952380953,23,29,22,22,96
"bronzeCat","bronzeCat_simpL10_qp10_qt10_decompJPEG_1024x1024_Q50",0.551136363636363,70,87,91,81,329
"rescue_craft","rescue_craft_simpL1_qp8_qt7_decompJPEG_1440x1440_Q25",0.926136363636362,94,77,72,69,312
"ET26_L_MK1","ET26_L_MK1_simpL10_qp10_qt6_decompJPEG_712x712_Q75",0.255813953488373,59,2,60,6,127
"bronzeCat","bronzeCat_simpL2_qp11_qt10_decompJPEG_2048x2048_Q10",0.160714285714285,70,87,91,81,329
"Deity_Earring_with_Vishnu_Garuda_and_chepu_100K","Deity_Earring_with_Vishnu_Garuda_and_chepu_100K_simpL3_qp8_qt10_decompJPEG_512x512_Q10",0.424418604651163,60,6,61,8,135
"Emberiza_calandra2","Emberiza_calandra2_simpL10_qp7_qt6_decompJPEG_512x512_Q10",0.636904761904763,23,29,22,22,96
"SitzenderKnabeNC","SitzenderKnabeNC_simpL5_qp9_qt6_decompJPEG_2048x2048_Q50",0.74404761904762,91,99,103,84,377
"Doryphoros_HighRes_4Mfaces_Simplified_BakedUV","Doryphoros_HighRes_4Mfaces_Simplified_BakedUV_simpL3_qp9_qt7_decompJPEG_512x512_Q90",0.784883720930233,25,23,26,23,97
"Elephant_zun_bakedUV","Elephant_zun_bakedUV_simpL9_qp9_qt8_decompJPEG_2048x2048_Q75",0.357142857142858,79,70,90,66,305
"model_Pastries_20180129_111506950","model_Pastries_20180129_111506950_simpL10_qp11_qt7_decompJPEG_1024x1024_Q90",0.75,59,45,37,63,204
"Deity_Earring_with_Vishnu_Garuda_and_chepu_100K","Deity_Earring_with_Vishnu_Garuda_and_chepu_100K_simpL3_qp8_qt10_decompJPEG_712x712_Q10",0.375,60,6,61,8,135
"rescue_craft","rescue_craft_simpL3_qp10_qt8_decompJPEG_712x712_Q10",0.323863636363637,94,77,72,69,312
"bear","bear_simpL2_qp10_qt7_decompJPEG_1024x1024_Q10",0.284883720930233,84,54,87,70,295
"model_Pastries_20180129_111506950","model_Pastries_20180129_111506950_simpL5_qp8_qt10_decompJPEG_512x512_Q25",0.61111111111111,59,45,37,63,204
"model_Pastries_20180129_111506950","model_Pastries_20180129_111506950_simpL9_qp9_qt10_decompJPEG_512x512_Q50",0.3375,59,45,37,63,204
"SitzenderKnabeNC","SitzenderKnabeNC_simpL10_qp9_qt10_decompJPEG_2048x2048_Q25",0.72159090909091,91,99,103,84,377
"Elephant_zun_bakedUV","Elephant_zun_bakedUV_simpL7_qp11_qt9_decompJPEG_512x512_Q75",0.383333333333333,79,70,90,66,305
"bronzeCat","bronzeCat_simpL1_qp10_qt8_decompJPEG_512x512_Q75",0.25,70,87,91,81,329
"Deity_Earring_with_Vishnu_Garuda_and_chepu_100K","Deity_Earring_with_Vishnu_Garuda_and_chepu_100K_simpL5_qp10_qt7_decompJPEG_512x512_Q25",0.297619047619047,60,6,61,8,135
"bronzeCat","bronzeCat_simpL5_qp9_qt10_decompJPEG_2048x2048_Q50",0.44767441860465,70,87,91,81,329
"Harrison_Front_Parlor_ChairSimplified","Harrison_Front_Parlor_ChairSimplified_simpL4_qp10_qt9_decompJPEG_2048x2048_Q10",0.36046511627907,82,33,63,31,209
"Elephant_zun_bakedUV","Elephant_zun_bakedUV_simpL8_qp9_qt6_decompJPEG_512x512_Q10",0.898809523809525,79,70,90,66,305
"rescue_craft","rescue_craft_simpL8_qp10_qt10_decompJPEG_712x712_Q50",0.333333333333332,94,77,72,69,312
"Doryphoros_HighRes_4Mfaces_Simplified_BakedUV","Doryphoros_HighRes_4Mfaces_Simplified_BakedUV_simpL2_qp10_qt7_decompJPEG_1024x1024_Q10",0.633720930232557,25,23,26,23,97
"Doryphoros_HighRes_4Mfaces_Simplified_BakedUV","Doryphoros_HighRes_4Mfaces_Simplified_BakedUV_simpL3_qp11_qt6_decompJPEG_2048x2048_Q50",0.829545454545455,25,23,26,23,97
"Deity_Earring_with_Vishnu_Garuda_and_chepu_100K","Deity_Earring_with_Vishnu_Garuda_and_chepu_100K_simpL3_qp9_qt10_decompJPEG_712x712_Q10",0.164772727272728,60,6,61,8,135
"Doryphoros_HighRes_4Mfaces_Simplified_BakedUV","Doryphoros_HighRes_4Mfaces_Simplified_BakedUV_simpL5_qp9_qt6_decompJPEG_2048x2048_Q25",0.851190476190475,25,23,26,23,97
"ET26_L_MK1","ET26_L_MK1_simpL10_qp10_qt6_decompJPEG_712x712_Q90",0.255813953488373,59,2,60,6,127
"Elephant_zun_bakedUV","Elephant_zun_bakedUV_simpL6_qp11_qt10_decompJPEG_712x712_Q75",0.19375,79,70,90,66,305
"Elephant_zun_bakedUV","Elephant_zun_bakedUV_simpL6_qp10_qt10_decompJPEG_512x512_Q90",0.30232558139535,79,70,90,66,305
"bear","bear_simpL8_qp11_qt10_decompJPEG_512x512_Q90",0.15340909090909,84,54,87,70,295
"SitzenderKnabeNC","SitzenderKnabeNC_simpL5_qp9_qt6_decompJPEG_512x512_Q90",0.547619047619047,91,99,103,84,377
"Emberiza_calandra2","Emberiza_calandra2_simpL10_qp10_qt6_decompJPEG_2048x2048_Q75",0.459302325581395,23,29,22,22,96
"bear","bear_simpL2_qp9_qt8_decompJPEG_2048x2048_Q50",0.475,84,54,87,70,295
"ET26_L_MK1","ET26_L_MK1_simpL10_qp10_qt6_decompJPEG_712x712_Q50",0.25,59,2,60,6,127
"bear","bear_simpL6_qp11_qt10_decompJPEG_512x512_Q50",0.227777777777777,84,54,87,70,295
"ET26_L_MK1","ET26_L_MK1_simpL10_qp8_qt6_decompJPEG_1440x1440_Q90",0.34375,59,2,60,6,127
"Deity_Earring_with_Vishnu_Garuda_and_chepu_100K","Deity_Earring_with_Vishnu_Garuda_and_chepu_100K_simpL9_qp9_qt7_decompJPEG_2048x2048_Q10",0.377906976744185,60,6,61,8,135
"ET26_L_MK1","ET26_L_MK1_simpL10_qp11_qt7_decompJPEG_1440x1440_Q75",0.13095238095238,59,2,60,6,127
"bronzeCat","bronzeCat_simpL10_qp8_qt10_decompJPEG_1440x1440_Q90",0.583333333333332,70,87,91,81,329
"rescue_craft","rescue_craft_simpL9_qp10_qt7_decompJPEG_712x712_Q25",0.494186046511627,94,77,72,69,312
"SitzenderKnabeNC","SitzenderKnabeNC_simpL8_qp8_qt7_decompJPEG_512x512_Q75",0.593023255813953,91,99,103,84,377
"bear","bear_simpL6_qp7_qt6_decompJPEG_512x512_Q50",0.976744186046512,84,54,87,70,295
"Deity_Earring_with_Vishnu_Garuda_and_chepu_100K","Deity_Earring_with_Vishnu_Garuda_and_chepu_100K_simpL9_qp7_qt8_decompJPEG_1024x1024_Q10",0.488372093023255,60,6,61,8,135
"bronzeCat","bronzeCat_simpL3_qp11_qt9_decompJPEG_2048x2048_Q10",0.193181818181817,70,87,91,81,329
"ET26_L_MK1","ET26_L_MK1_simpL10_qp8_qt7_decompJPEG_1440x1440_Q25",0.238095238095237,59,2,60,6,127
"Doryphoros_HighRes_4Mfaces_Simplified_BakedUV","Doryphoros_HighRes_4Mfaces_Simplified_BakedUV_simpL3_qp7_qt10_decompJPEG_1024x1024_Q90",0.994444444444445,25,23,26,23,97
"rescue_craft","rescue_craft_simpL1_qp10_qt7_decompJPEG_512x512_Q25",0.365853658536585,94,77,72,69,312
"SitzenderKnabeNC","SitzenderKnabeNC_simpL5_qp8_qt8_decompJPEG_2048x2048_Q50",0.527777777777777,91,99,103,84,377
"Deity_Earring_with_Vishnu_Garuda_and_chepu_100K","Deity_Earring_with_Vishnu_Garuda_and_chepu_100K_simpL9_qp9_qt7_decompJPEG_712x712_Q50",0.329545454545455,60,6,61,8,135
"Doryphoros_HighRes_4Mfaces_Simplified_BakedUV","Doryphoros_HighRes_4Mfaces_Simplified_BakedUV_simpL4_qp11_qt6_decompJPEG_1024x1024_Q75",0.83125,25,23,26,23,97
"Elephant_zun_bakedUV","Elephant_zun_bakedUV_simpL4_qp11_qt8_decompJPEG_2048x2048_Q90",0.162790697674418,79,70,90,66,305
"ET26_L_MK1","ET26_L_MK1_simpL10_qp8_qt6_decompJPEG_1440x1440_Q75",0.347560975609755,59,2,60,6,127
"Harrison_Front_Parlor_ChairSimplified","Harrison_Front_Parlor_ChairSimplified_simpL3_qp11_qt8_decompJPEG_2048x2048_Q90",0.601190476190475,82,33,63,31,209
"model_Pastries_20180129_111506950","model_Pastries_20180129_111506950_simpL10_qp11_qt6_decompJPEG_2048x2048_Q75",0.892857142857143,59,45,37,63,204
"ET26_L_MK1","ET26_L_MK1_simpL2_qp9_qt8_decompJPEG_512x512_Q25",0.4375,59,2,60,6,127
"Deity_Earring_with_Vishnu_Garuda_and_chepu_100K","Deity_Earring_with_Vishnu_Garuda_and_chepu_100K_simpL8_qp8_qt6_decompJPEG_2048x2048_Q10",0.796052631578948,60,6,61,8,135
"Elephant_zun_bakedUV","Elephant_zun_bakedUV_simpL5_qp10_qt10_decompJPEG_512x512_Q90",0.21590909090909,79,70,90,66,305
"ET26_L_MK1","ET26_L_MK1_simpL10_qp10_qt6_decompJPEG_512x512_Q90",0.238636363636362,59,2,60,6,127
"Harrison_Front_Parlor_ChairSimplified","Harrison_Front_Parlor_ChairSimplified_simpL5_qp11_qt7_decompJPEG_512x512_Q75",0.78409090909091,82,33,63,31,209
"Deity_Earring_with_Vishnu_Garuda_and_chepu_100K","Deity_Earring_with_Vishnu_Garuda_and_chepu_100K_simpL3_qp10_qt7_decompJPEG_512x512_Q25",0.405555555555555,60,6,61,8,135
"SitzenderKnabeNC","SitzenderKnabeNC_simpL4_qp11_qt10_decompJPEG_712x712_Q10",0.25,91,99,103,84,377
"bronzeCat","bronzeCat_simpL1_qp11_qt9_decompJPEG_512x512_Q75",0.125,70,87,91,81,329
"bronzeCat","bronzeCat_simpL10_qp11_qt9_decompJPEG_1024x1024_Q25",0.654761904761905,70,87,91,81,329
"rescue_craft","rescue_craft_simpL7_qp11_qt8_decompJPEG_712x712_Q10",0.30232558139535,94,77,72,69,312
"model_Pastries_20180129_111506950","model_Pastries_20180129_111506950_simpL9_qp10_qt6_decompJPEG_712x712_Q10",0.926136363636362,59,45,37,63,204
"bronzeCat","bronzeCat_simpL9_qp9_qt9_decompJPEG_1440x1440_Q10",0.365853658536585,70,87,91,81,329
"model_Pastries_20180129_111506950","model_Pastries_20180129_111506950_simpL10_qp10_qt8_decompJPEG_2048x2048_Q50",0.602272727272728,59,45,37,63,204
"Harrison_Front_Parlor_ChairSimplified","Harrison_Front_Parlor_ChairSimplified_simpL1_qp11_qt8_decompJPEG_2048x2048_Q90",0.645348837209302,82,33,63,31,209
"ET26_L_MK1","ET26_L_MK1_simpL10_qp9_qt7_decompJPEG_712x712_Q50",0.210227272727272,59,2,60,6,127
"bear","bear_simpL10_qp11_qt8_decompJPEG_2048x2048_Q25",0.709302325581395,84,54,87,70,295
"SitzenderKnabeNC","SitzenderKnabeNC_simpL10_qp8_qt6_decompJPEG_1024x1024_Q75",0.784883720930233,91,99,103,84,377
"Emberiza_calandra2","Emberiza_calandra2_simpL10_qp9_qt6_decompJPEG_712x712_Q50",0.55232558139535,23,29,22,22,96
"Elephant_zun_bakedUV","Elephant_zun_bakedUV_simpL1_qp11_qt10_decompJPEG_512x512_Q90",0.1625,79,70,90,66,305
"bronzeCat","bronzeCat_simpL1_qp10_qt8_decompJPEG_512x512_Q50",0.227272727272728,70,87,91,81,329
"Elephant_zun_bakedUV","Elephant_zun_bakedUV_simpL6_qp11_qt10_decompJPEG_712x712_Q90",0.170454545454545,79,70,90,66,305
"SitzenderKnabeNC","SitzenderKnabeNC_simpL1_qp11_qt7_decompJPEG_2048x2048_Q90",0.41111111111111,91,99,103,84,377
"Harrison_Front_Parlor_ChairSimplified","Harrison_Front_Parlor_ChairSimplified_simpL6_qp11_qt7_decompJPEG_512x512_Q25",0.86904761904762,82,33,63,31,209
"SitzenderKnabeNC","SitzenderKnabeNC_simpL9_qp10_qt6_decompJPEG_1440x1440_Q90",0.693181818181817,91,99,103,84,377
"Emberiza_calandra2","Emberiza_calandra2_simpL10_qp7_qt7_decompJPEG_712x712_Q90",0.46111111111111,23,29,22,22,96
"rescue_craft","rescue_craft_simpL9_qp8_qt6_decompJPEG_712x712_Q25",0.872093023255815,94,77,72,69,312
"rescue_craft","rescue_craft_simpL9_qp9_qt8_decompJPEG_1440x1440_Q10",0.59090909090909,94,77,72,69,312
"Harrison_Front_Parlor_ChairSimplified","Harrison_Front_Parlor_ChairSimplified_simpL8_qp11_qt7_decompJPEG_512x512_Q90",0.813953488372092,82,33,63,31,209
"ET26_L_MK1","ET26_L_MK1_simpL2_qp9_qt8_decompJPEG_1024x1024_Q50",0.323863636363637,59,2,60,6,127
"model_Pastries_20180129_111506950","model_Pastries_20180129_111506950_simpL10_qp11_qt8_decompJPEG_2048x2048_Q75",0.55232558139535,59,45,37,63,204
"ET26_L_MK1","ET26_L_MK1_simpL10_qp11_qt7_decompJPEG_2048x2048_Q10",0.194444444444445,59,2,60,6,127
"ET26_L_MK1","ET26_L_MK1_simpL10_qp8_qt7_decompJPEG_1440x1440_Q50",0.25,59,2,60,6,127
"Doryphoros_HighRes_4Mfaces_Simplified_BakedUV","Doryphoros_HighRes_4Mfaces_Simplified_BakedUV_simpL4_qp10_qt6_decompJPEG_2048x2048_Q90",0.843023255813953,25,23,26,23,97
"rescue_craft","rescue_craft_simpL6_qp8_qt7_decompJPEG_2048x2048_Q90",0.83974358974359,94,77,72,69,312
"bronzeCat","bronzeCat_simpL1_qp10_qt8_decompJPEG_1024x1024_Q10",0.267045454545455,70,87,91,81,329
"Elephant_zun_bakedUV","Elephant_zun_bakedUV_simpL9_qp10_qt7_decompJPEG_1440x1440_Q75",0.482558139534882,79,70,90,66,305
"Doryphoros_HighRes_4Mfaces_Simplified_BakedUV","Doryphoros_HighRes_4Mfaces_Simplified_BakedUV_simpL4_qp10_qt6_decompJPEG_2048x2048_Q75",0.83139534883721,25,23,26,23,97
"Elephant_zun_bakedUV","Elephant_zun_bakedUV_simpL9_qp10_qt7_decompJPEG_2048x2048_Q90",0.47093023255814,79,70,90,66,305
"bronzeCat","bronzeCat_simpL10_qp9_qt7_decompJPEG_2048x2048_Q25",0.6,70,87,91,81,329
"Emberiza_calandra2","Emberiza_calandra2_simpL4_qp8_qt9_decompJPEG_712x712_Q50",0.71875,23,29,22,22,96
"rescue_craft","rescue_craft_simpL6_qp11_qt10_decompJPEG_512x512_Q25",0.232558139534883,94,77,72,69,312
"Doryphoros_HighRes_4Mfaces_Simplified_BakedUV","Doryphoros_HighRes_4Mfaces_Simplified_BakedUV_simpL9_qp11_qt6_decompJPEG_512x512_Q50",0.686046511627908,25,23,26,23,97
"model_Pastries_20180129_111506950","model_Pastries_20180129_111506950_simpL10_qp10_qt6_decompJPEG_1024x1024_Q90",0.854651162790698,59,45,37,63,204
"model_Pastries_20180129_111506950","model_Pastries_20180129_111506950_simpL10_qp10_qt7_decompJPEG_1024x1024_Q90",0.75,59,45,37,63,204
"bronzeCat","bronzeCat_simpL10_qp10_qt10_decompJPEG_2048x2048_Q90",0.572222222222223,70,87,91,81,329
"Harrison_Front_Parlor_ChairSimplified","Harrison_Front_Parlor_ChairSimplified_simpL7_qp11_qt7_decompJPEG_712x712_Q75",0.81547619047619,82,33,63,31,209
"bear","bear_simpL1_qp8_qt6_decompJPEG_2048x2048_Q10",0.925,84,54,87,70,295
"Harrison_Front_Parlor_ChairSimplified","Harrison_Front_Parlor_ChairSimplified_simpL9_qp11_qt6_decompJPEG_712x712_Q50",0.851190476190475,82,33,63,31,209
"ET26_L_MK1","ET26_L_MK1_simpL10_qp11_qt7_decompJPEG_712x712_Q90",0.164772727272728,59,2,60,6,127
"Elephant_zun_bakedUV","Elephant_zun_bakedUV_simpL8_qp10_qt8_decompJPEG_1024x1024_Q75",0.21590909090909,79,70,90,66,305
"SitzenderKnabeNC","SitzenderKnabeNC_simpL3_qp9_qt6_decompJPEG_512x512_Q50",0.546511627906977,91,99,103,84,377
"Harrison_Front_Parlor_ChairSimplified","Harrison_Front_Parlor_ChairSimplified_simpL1_qp9_qt10_decompJPEG_2048x2048_Q25",0.325,82,33,63,31,209
"ET26_L_MK1","ET26_L_MK1_simpL10_qp9_qt7_decompJPEG_712x712_Q75",0.185897435897435,59,2,60,6,127
"bear","bear_simpL9_qp11_qt9_decompJPEG_512x512_Q10",0.420454545454545,84,54,87,70,295
"ET26_L_MK1","ET26_L_MK1_simpL10_qp10_qt7_decompJPEG_1440x1440_Q25",0.174418604651162,59,2,60,6,127
"Doryphoros_HighRes_4Mfaces_Simplified_BakedUV","Doryphoros_HighRes_4Mfaces_Simplified_BakedUV_simpL8_qp7_qt8_decompJPEG_1024x1024_Q90",0.976744186046512,25,23,26,23,97
"SitzenderKnabeNC","SitzenderKnabeNC_simpL8_qp8_qt9_decompJPEG_512x512_Q50",0.50625,91,99,103,84,377
"Harrison_Front_Parlor_ChairSimplified","Harrison_Front_Parlor_ChairSimplified_simpL9_qp8_qt9_decompJPEG_1440x1440_Q75",0.547619047619047,82,33,63,31,209
"model_Pastries_20180129_111506950","model_Pastries_20180129_111506950_simpL10_qp10_qt6_decompJPEG_1440x1440_Q90",0.857142857142857,59,45,37,63,204
"model_Pastries_20180129_111506950","model_Pastries_20180129_111506950_simpL10_qp10_qt10_decompJPEG_1440x1440_Q25",0.594444444444445,59,45,37,63,204
"ET26_L_MK1","ET26_L_MK1_simpL2_qp9_qt10_decompJPEG_512x512_Q25",0.261363636363637,59,2,60,6,127
"Harrison_Front_Parlor_ChairSimplified","Harrison_Front_Parlor_ChairSimplified_simpL5_qp11_qt8_decompJPEG_512x512_Q90",0.69186046511628,82,33,63,31,209
"Elephant_zun_bakedUV","Elephant_zun_bakedUV_simpL3_qp11_qt10_decompJPEG_512x512_Q90",0.232558139534883,79,70,90,66,305
"Elephant_zun_bakedUV","Elephant_zun_bakedUV_simpL1_qp11_qt7_decompJPEG_1024x1024_Q50",0.319767441860465,79,70,90,66,305
"bear","bear_simpL6_qp9_qt7_decompJPEG_2048x2048_Q90",0.432926829268293,84,54,87,70,295
"Emberiza_calandra2","Emberiza_calandra2_simpL7_qp10_qt7_decompJPEG_512x512_Q50",0.451219512195122,23,29,22,22,96
"rescue_craft","rescue_craft_simpL9_qp10_qt7_decompJPEG_1024x1024_Q10",0.52906976744186,94,77,72,69,312
"bronzeCat","bronzeCat_simpL7_qp9_qt8_decompJPEG_1024x1024_Q75",0.424418604651163,70,87,91,81,329
"model_Pastries_20180129_111506950","model_Pastries_20180129_111506950_simpL10_qp11_qt9_decompJPEG_1024x1024_Q75",0.476190476190475,59,45,37,63,204
"model_Pastries_20180129_111506950","model_Pastries_20180129_111506950_simpL10_qp11_qt7_decompJPEG_2048x2048_Q75",0.708333333333332,59,45,37,63,204
"SitzenderKnabeNC","SitzenderKnabeNC_simpL6_qp11_qt7_decompJPEG_1440x1440_Q50",0.394444444444445,91,99,103,84,377
"bear","bear_simpL7_qp11_qt10_decompJPEG_512x512_Q90",0.176829268292682,84,54,87,70,295
"bronzeCat","bronzeCat_simpL10_qp9_qt9_decompJPEG_1440x1440_Q25",0.5,70,87,91,81,329
"SitzenderKnabeNC","SitzenderKnabeNC_simpL9_qp10_qt6_decompJPEG_712x712_Q75",0.656976744186047,91,99,103,84,377
"ET26_L_MK1","ET26_L_MK1_simpL10_qp11_qt7_decompJPEG_1440x1440_Q50",0.15909090909091,59,2,60,6,127
"Harrison_Front_Parlor_ChairSimplified","Harrison_Front_Parlor_ChairSimplified_simpL4_qp9_qt10_decompJPEG_1024x1024_Q90",0.375,82,33,63,31,209
"Emberiza_calandra2","Emberiza_calandra2_simpL2_qp7_qt6_decompJPEG_2048x2048_Q25",0.94186046511628,23,29,22,22,96
"Elephant_zun_bakedUV","Elephant_zun_bakedUV_simpL8_qp10_qt9_decompJPEG_2048x2048_Q75",0.11904761904762,79,70,90,66,305
"SitzenderKnabeNC","SitzenderKnabeNC_simpL8_qp7_qt7_decompJPEG_1024x1024_Q25",0.91860465116279,91,99,103,84,377
"bronzeCat","bronzeCat_simpL2_qp9_qt9_decompJPEG_512x512_Q75",0.464285714285715,70,87,91,81,329
"Emberiza_calandra2","Emberiza_calandra2_simpL4_qp8_qt9_decompJPEG_712x712_Q25",0.642857142857142,23,29,22,22,96
"Emberiza_calandra2","Emberiza_calandra2_simpL3_qp8_qt6_decompJPEG_2048x2048_Q50",0.853658536585365,23,29,22,22,96
"Doryphoros_HighRes_4Mfaces_Simplified_BakedUV","Doryphoros_HighRes_4Mfaces_Simplified_BakedUV_simpL6_qp11_qt6_decompJPEG_2048x2048_Q90",0.795454545454545,25,23,26,23,97
"Harrison_Front_Parlor_ChairSimplified","Harrison_Front_Parlor_ChairSimplified_simpL9_qp9_qt9_decompJPEG_1440x1440_Q90",0.273255813953488,82,33,63,31,209
"model_Pastries_20180129_111506950","model_Pastries_20180129_111506950_simpL10_qp11_qt8_decompJPEG_1024x1024_Q75",0.58125,59,45,37,63,204
"Emberiza_calandra2","Emberiza_calandra2_simpL10_qp10_qt6_decompJPEG_1440x1440_Q50",0.5,23,29,22,22,96
"Deity_Earring_with_Vishnu_Garuda_and_chepu_100K","Deity_Earring_with_Vishnu_Garuda_and_chepu_100K_simpL1_qp8_qt9_decompJPEG_512x512_Q10",0.50595238095238,60,6,61,8,135
"Emberiza_calandra2","Emberiza_calandra2_simpL6_qp8_qt6_decompJPEG_2048x2048_Q50",0.924418604651162,23,29,22,22,96
"bear","bear_simpL8_qp11_qt9_decompJPEG_512x512_Q75",0.213414634146343,84,54,87,70,295
"Doryphoros_HighRes_4Mfaces_Simplified_BakedUV","Doryphoros_HighRes_4Mfaces_Simplified_BakedUV_simpL3_qp10_qt6_decompJPEG_2048x2048_Q10",0.84090909090909,25,23,26,23,97
"Deity_Earring_with_Vishnu_Garuda_and_chepu_100K","Deity_Earring_with_Vishnu_Garuda_and_chepu_100K_simpL9_qp9_qt7_decompJPEG_1440x1440_Q10",0.327380952380953,60,6,61,8,135
"Deity_Earring_with_Vishnu_Garuda_and_chepu_100K","Deity_Earring_with_Vishnu_Garuda_and_chepu_100K_simpL9_qp11_qt6_decompJPEG_1440x1440_Q50",0.594444444444445,60,6,61,8,135
"model_Pastries_20180129_111506950","model_Pastries_20180129_111506950_simpL9_qp11_qt10_decompJPEG_512x512_Q50",0.3,59,45,37,63,204
"Elephant_zun_bakedUV","Elephant_zun_bakedUV_simpL9_qp10_qt8_decompJPEG_2048x2048_Q50",0.30952380952381,79,70,90,66,305
"Elephant_zun_bakedUV","Elephant_zun_bakedUV_simpL9_qp11_qt7_decompJPEG_2048x2048_Q90",0.48076923076923,79,70,90,66,305
"ET26_L_MK1","ET26_L_MK1_simpL10_qp9_qt7_decompJPEG_1440x1440_Q50",0.181818181818183,59,2,60,6,127
"Harrison_Front_Parlor_ChairSimplified","Harrison_Front_Parlor_ChairSimplified_simpL1_qp9_qt10_decompJPEG_1440x1440_Q25",0.425,82,33,63,31,209
"Doryphoros_HighRes_4Mfaces_Simplified_BakedUV","Doryphoros_HighRes_4Mfaces_Simplified_BakedUV_simpL7_qp8_qt6_decompJPEG_2048x2048_Q25",0.939024390243902,25,23,26,23,97
"Deity_Earring_with_Vishnu_Garuda_and_chepu_100K","Deity_Earring_with_Vishnu_Garuda_and_chepu_100K_simpL9_qp9_qt7_decompJPEG_1024x1024_Q25",0.34090909090909,60,6,61,8,135
"rescue_craft","rescue_craft_simpL1_qp9_qt9_decompJPEG_512x512_Q50",0.587209302325583,94,77,72,69,312
"Elephant_zun_bakedUV","Elephant_zun_bakedUV_simpL4_qp9_qt8_decompJPEG_1024x1024_Q75",0.21951219512195,79,70,90,66,305
"rescue_craft","rescue_craft_simpL9_qp10_qt8_decompJPEG_1440x1440_Q25",0.45,94,77,72,69,312
"bronzeCat","bronzeCat_simpL6_qp9_qt10_decompJPEG_712x712_Q75",0.426136363636363,70,87,91,81,329
"ET26_L_MK1","ET26_L_MK1_simpL10_qp11_qt6_decompJPEG_712x712_Q90",0.26875,59,2,60,6,127
"model_Pastries_20180129_111506950","model_Pastries_20180129_111506950_simpL8_qp11_qt10_decompJPEG_512x512_Q90",0.33125,59,45,37,63,204
"bear","bear_simpL4_qp9_qt9_decompJPEG_1024x1024_Q10",0.511363636363637,84,54,87,70,295
"model_Pastries_20180129_111506950","model_Pastries_20180129_111506950_simpL10_qp8_qt8_decompJPEG_1440x1440_Q90",0.616279069767443,59,45,37,63,204
"Doryphoros_HighRes_4Mfaces_Simplified_BakedUV","Doryphoros_HighRes_4Mfaces_Simplified_BakedUV_simpL9_qp8_qt10_decompJPEG_1440x1440_Q10",0.898809523809525,25,23,26,23,97
"bear","bear_simpL8_qp10_qt8_decompJPEG_512x512_Q25",0.25595238095238,84,54,87,70,295
"Harrison_Front_Parlor_ChairSimplified","Harrison_Front_Parlor_ChairSimplified_simpL2_qp10_qt10_decompJPEG_1024x1024_Q90",0.13953488372093,82,33,63,31,209
"bronzeCat","bronzeCat_simpL2_qp10_qt9_decompJPEG_512x512_Q90",0.19375,70,87,91,81,329
"rescue_craft","rescue_craft_simpL2_qp11_qt8_decompJPEG_1440x1440_Q90",0.127906976744185,94,77,72,69,312
"Elephant_zun_bakedUV","Elephant_zun_bakedUV_simpL10_qp7_qt7_decompJPEG_712x712_Q10",1,79,70,90,66,305
"bear","bear_simpL1_qp11_qt10_decompJPEG_712x712_Q50",0.069767441860465,84,54,87,70,295
"Emberiza_calandra2","Emberiza_calandra2_simpL10_qp9_qt6_decompJPEG_2048x2048_Q25",0.511627906976745,23,29,22,22,96
"Emberiza_calandra2","Emberiza_calandra2_simpL5_qp7_qt6_decompJPEG_712x712_Q75",0.97093023255814,23,29,22,22,96
"bear","bear_simpL8_qp11_qt10_decompJPEG_712x712_Q75",0.0952380952380949,84,54,87,70,295
"rescue_craft","rescue_craft_simpL7_qp11_qt7_decompJPEG_2048x2048_Q10",0.321428571428573,94,77,72,69,312
"Elephant_zun_bakedUV","Elephant_zun_bakedUV_simpL5_qp11_qt10_decompJPEG_512x512_Q90",0.207317073170733,79,70,90,66,305
"bear","bear_simpL5_qp9_qt8_decompJPEG_1024x1024_Q10",0.464285714285715,84,54,87,70,295
"Emberiza_calandra2","Emberiza_calandra2_simpL10_qp11_qt6_decompJPEG_2048x2048_Q50",0.592105263157895,23,29,22,22,96
"Elephant_zun_bakedUV","Elephant_zun_bakedUV_simpL8_qp9_qt6_decompJPEG_512x512_Q25",0.74404761904762,79,70,90,66,305
"bear","bear_simpL1_qp10_qt6_decompJPEG_1440x1440_Q10",0.613636363636363,84,54,87,70,295
"Deity_Earring_with_Vishnu_Garuda_and_chepu_100K","Deity_Earring_with_Vishnu_Garuda_and_chepu_100K_simpL9_qp9_qt9_decompJPEG_2048x2048_Q10",0.255813953488373,60,6,61,8,135
"rescue_craft","rescue_craft_simpL5_qp11_qt10_decompJPEG_512x512_Q10",0.318181818181817,94,77,72,69,312
"Harrison_Front_Parlor_ChairSimplified","Harrison_Front_Parlor_ChairSimplified_simpL1_qp10_qt10_decompJPEG_1024x1024_Q75",0.15625,82,33,63,31,209
"bear","bear_simpL9_qp11_qt9_decompJPEG_512x512_Q50",0.301136363636363,84,54,87,70,295
"bronzeCat","bronzeCat_simpL9_qp11_qt10_decompJPEG_512x512_Q25",0.372222222222222,70,87,91,81,329
"bear","bear_simpL2_qp8_qt6_decompJPEG_2048x2048_Q10",0.892857142857143,84,54,87,70,295
"model_Pastries_20180129_111506950","model_Pastries_20180129_111506950_simpL10_qp8_qt8_decompJPEG_1440x1440_Q25",0.636904761904763,59,45,37,63,204
"SitzenderKnabeNC","SitzenderKnabeNC_simpL4_qp11_qt8_decompJPEG_712x712_Q10",0.275,91,99,103,84,377
"rescue_craft","rescue_craft_simpL4_qp10_qt8_decompJPEG_712x712_Q75",0.345238095238095,94,77,72,69,312
"Emberiza_calandra2","Emberiza_calandra2_simpL10_qp7_qt7_decompJPEG_712x712_Q75",0.539772727272728,23,29,22,22,96
"rescue_craft","rescue_craft_simpL7_qp11_qt9_decompJPEG_712x712_Q10",0.261363636363637,94,77,72,69,312
"SitzenderKnabeNC","SitzenderKnabeNC_simpL3_qp8_qt8_decompJPEG_512x512_Q90",0.738095238095237,91,99,103,84,377
"Emberiza_calandra2","Emberiza_calandra2_simpL3_qp10_qt6_decompJPEG_2048x2048_Q75",0.926829268292682,23,29,22,22,96
"rescue_craft","rescue_craft_simpL8_qp10_qt9_decompJPEG_1024x1024_Q25",0.289772727272728,94,77,72,69,312
"SitzenderKnabeNC","SitzenderKnabeNC_simpL9_qp8_qt7_decompJPEG_2048x2048_Q50",0.55952380952381,91,99,103,84,377
"bear","bear_simpL8_qp10_qt10_decompJPEG_512x512_Q50",0.19767441860465,84,54,87,70,295
"ET26_L_MK1","ET26_L_MK1_simpL10_qp8_qt7_decompJPEG_512x512_Q90",0.166666666666667,59,2,60,6,127
"Emberiza_calandra2","Emberiza_calandra2_simpL10_qp7_qt6_decompJPEG_1440x1440_Q10",0.615853658536585,23,29,22,22,96
"bronzeCat","bronzeCat_simpL1_qp10_qt10_decompJPEG_1024x1024_Q75",0.128048780487805,70,87,91,81,329
"Emberiza_calandra2","Emberiza_calandra2_simpL10_qp9_qt6_decompJPEG_712x712_Q75",0.522727272727272,23,29,22,22,96
"bear","bear_simpL7_qp11_qt10_decompJPEG_512x512_Q50",0.213414634146343,84,54,87,70,295
"Doryphoros_HighRes_4Mfaces_Simplified_BakedUV","Doryphoros_HighRes_4Mfaces_Simplified_BakedUV_simpL6_qp11_qt6_decompJPEG_512x512_Q90",0.835365853658538,25,23,26,23,97
"SitzenderKnabeNC","SitzenderKnabeNC_simpL6_qp8_qt8_decompJPEG_1024x1024_Q25",0.563953488372092,91,99,103,84,377
"Emberiza_calandra2","Emberiza_calandra2_simpL10_qp10_qt6_decompJPEG_1024x1024_Q75",0.578947368421053,23,29,22,22,96
"bear","bear_simpL8_qp9_qt6_decompJPEG_1024x1024_Q90",0.577777777777778,84,54,87,70,295
"Deity_Earring_with_Vishnu_Garuda_and_chepu_100K","Deity_Earring_with_Vishnu_Garuda_and_chepu_100K_simpL9_qp7_qt9_decompJPEG_2048x2048_Q25",0.476190476190475,60,6,61,8,135
"bear","bear_simpL7_qp11_qt9_decompJPEG_512x512_Q50",0.2125,84,54,87,70,295
"Emberiza_calandra2","Emberiza_calandra2_simpL10_qp10_qt6_decompJPEG_1024x1024_Q10",0.50625,23,29,22,22,96
"bronzeCat","bronzeCat_simpL10_qp8_qt8_decompJPEG_2048x2048_Q75",0.585526315789472,70,87,91,81,329
"Deity_Earring_with_Vishnu_Garuda_and_chepu_100K","Deity_Earring_with_Vishnu_Garuda_and_chepu_100K_simpL2_qp10_qt7_decompJPEG_512x512_Q10",0.341463414634148,60,6,61,8,135
"bear","bear_simpL5_qp7_qt9_decompJPEG_2048x2048_Q75",0.983333333333333,84,54,87,70,295
"bronzeCat","bronzeCat_simpL2_qp10_qt8_decompJPEG_512x512_Q50",0.267857142857142,70,87,91,81,329
"Harrison_Front_Parlor_ChairSimplified","Harrison_Front_Parlor_ChairSimplified_simpL9_qp8_qt9_decompJPEG_1440x1440_Q50",0.55952380952381,82,33,63,31,209
"Doryphoros_HighRes_4Mfaces_Simplified_BakedUV","Doryphoros_HighRes_4Mfaces_Simplified_BakedUV_simpL2_qp7_qt6_decompJPEG_2048x2048_Q10",0.970238095238095,25,23,26,23,97
"ET26_L_MK1","ET26_L_MK1_simpL10_qp8_qt7_decompJPEG_712x712_Q50",0.198863636363638,59,2,60,6,127
"model_Pastries_20180129_111506950","model_Pastries_20180129_111506950_simpL10_qp10_qt6_decompJPEG_1024x1024_Q25",0.90909090909091,59,45,37,63,204
"rescue_craft","rescue_craft_simpL9_qp9_qt7_decompJPEG_1440x1440_Q10",0.619318181818183,94,77,72,69,312
"bronzeCat","bronzeCat_simpL9_qp11_qt8_decompJPEG_512x512_Q25",0.353658536585365,70,87,91,81,329
"model_Pastries_20180129_111506950","model_Pastries_20180129_111506950_simpL10_qp11_qt6_decompJPEG_1024x1024_Q25",0.886363636363638,59,45,37,63,204
"SitzenderKnabeNC","SitzenderKnabeNC_simpL3_qp11_qt10_decompJPEG_712x712_Q10",0.255813953488373,91,99,103,84,377
"Emberiza_calandra2","Emberiza_calandra2_simpL6_qp8_qt6_decompJPEG_2048x2048_Q10",0.897727272727272,23,29,22,22,96
"bear","bear_simpL9_qp9_qt10_decompJPEG_512x512_Q90",0.30232558139535,84,54,87,70,295
"rescue_craft","rescue_craft_simpL9_qp8_qt9_decompJPEG_2048x2048_Q50",0.789772727272728,94,77,72,69,312
"Emberiza_calandra2","Emberiza_calandra2_simpL3_qp8_qt6_decompJPEG_2048x2048_Q10",0.90340909090909,23,29,22,22,96
"bear","bear_simpL8_qp11_qt9_decompJPEG_512x512_Q50",0.192307692307693,84,54,87,70,295
"Doryphoros_HighRes_4Mfaces_Simplified_BakedUV","Doryphoros_HighRes_4Mfaces_Simplified_BakedUV_simpL7_qp9_qt6_decompJPEG_512x512_Q25",0.819767441860465,25,23,26,23,97
"bronzeCat","bronzeCat_simpL1_qp10_qt9_decompJPEG_2048x2048_Q10",0.244186046511627,70,87,91,81,329
"Harrison_Front_Parlor_ChairSimplified","Harrison_Front_Parlor_ChairSimplified_simpL6_qp11_qt8_decompJPEG_2048x2048_Q90",0.616279069767443,82,33,63,31,209
"SitzenderKnabeNC","SitzenderKnabeNC_simpL9_qp7_qt6_decompJPEG_512x512_Q10",0.896341463414635,91,99,103,84,377
"bear","bear_simpL10_qp10_qt8_decompJPEG_1024x1024_Q25",0.696428571428573,84,54,87,70,295
"ET26_L_MK1","ET26_L_MK1_simpL10_qp9_qt6_decompJPEG_712x712_Q50",0.297619047619047,59,2,60,6,127
"Emberiza_calandra2","Emberiza_calandra2_simpL2_qp7_qt6_decompJPEG_1440x1440_Q90",0.982954545454545,23,29,22,22,96
"ET26_L_MK1","ET26_L_MK1_simpL10_qp11_qt6_decompJPEG_1440x1440_Q90",0.28888888888889,59,2,60,6,127
"Elephant_zun_bakedUV","Elephant_zun_bakedUV_simpL2_qp9_qt6_decompJPEG_512x512_Q75",0.555555555555555,79,70,90,66,305
"Emberiza_calandra2","Emberiza_calandra2_simpL3_qp9_qt6_decompJPEG_2048x2048_Q75",0.914634146341462,23,29,22,22,96
"bronzeCat","bronzeCat_simpL10_qp9_qt9_decompJPEG_2048x2048_Q25",0.553571428571427,70,87,91,81,329
"model_Pastries_20180129_111506950","model_Pastries_20180129_111506950_simpL10_qp11_qt7_decompJPEG_2048x2048_Q50",0.725,59,45,37,63,204
"model_Pastries_20180129_111506950","model_Pastries_20180129_111506950_simpL10_qp11_qt7_decompJPEG_2048x2048_Q90",0.81547619047619,59,45,37,63,204
"Deity_Earring_with_Vishnu_Garuda_and_chepu_100K","Deity_Earring_with_Vishnu_Garuda_and_chepu_100K_simpL1_qp9_qt7_decompJPEG_1024x1024_Q50",0.401162790697675,60,6,61,8,135
"SitzenderKnabeNC","SitzenderKnabeNC_simpL8_qp8_qt6_decompJPEG_2048x2048_Q10",0.704545454545455,91,99,103,84,377
"SitzenderKnabeNC","SitzenderKnabeNC_simpL3_qp10_qt6_decompJPEG_512x512_Q50",0.601190476190475,91,99,103,84,377
"bronzeCat","bronzeCat_simpL1_qp10_qt9_decompJPEG_512x512_Q90",0.164634146341462,70,87,91,81,329
"Elephant_zun_bakedUV","Elephant_zun_bakedUV_simpL6_qp10_qt10_decompJPEG_512x512_Q75",0.291666666666668,79,70,90,66,305
"bear","bear_simpL7_qp11_qt10_decompJPEG_512x512_Q75",0.13095238095238,84,54,87,70,295
"Elephant_zun_bakedUV","Elephant_zun_bakedUV_simpL2_qp10_qt10_decompJPEG_1024x1024_Q25",0.181818181818183,79,70,90,66,305
"bear","bear_simpL9_qp8_qt10_decompJPEG_512x512_Q50",0.630681818181817,84,54,87,70,295
"rescue_craft","rescue_craft_simpL7_qp9_qt7_decompJPEG_2048x2048_Q50",0.601190476190475,94,77,72,69,312
"Doryphoros_HighRes_4Mfaces_Simplified_BakedUV","Doryphoros_HighRes_4Mfaces_Simplified_BakedUV_simpL9_qp8_qt10_decompJPEG_2048x2048_Q25",0.86046511627907,25,23,26,23,97
"Doryphoros_HighRes_4Mfaces_Simplified_BakedUV","Doryphoros_HighRes_4Mfaces_Simplified_BakedUV_simpL2_qp10_qt6_decompJPEG_1024x1024_Q25",0.86875,25,23,26,23,97
"bear","bear_simpL4_qp11_qt7_decompJPEG_512x512_Q90",0.36904761904762,84,54,87,70,295
"model_Pastries_20180129_111506950","model_Pastries_20180129_111506950_simpL10_qp7_qt6_decompJPEG_1024x1024_Q75",0.848837209302325,59,45,37,63,204
"SitzenderKnabeNC","SitzenderKnabeNC_simpL7_qp9_qt6_decompJPEG_512x512_Q90",0.55952380952381,91,99,103,84,377
"bear","bear_simpL9_qp9_qt9_decompJPEG_512x512_Q25",0.306818181818183,84,54,87,70,295
"Doryphoros_HighRes_4Mfaces_Simplified_BakedUV","Doryphoros_HighRes_4Mfaces_Simplified_BakedUV_simpL5_qp9_qt6_decompJPEG_2048x2048_Q50",0.833333333333332,25,23,26,23,97
"SitzenderKnabeNC","SitzenderKnabeNC_simpL4_qp11_qt10_decompJPEG_1024x1024_Q10",0.209302325581395,91,99,103,84,377
"Doryphoros_HighRes_4Mfaces_Simplified_BakedUV","Doryphoros_HighRes_4Mfaces_Simplified_BakedUV_simpL5_qp10_qt6_decompJPEG_2048x2048_Q10",0.792682926829267,25,23,26,23,97
"ET26_L_MK1","ET26_L_MK1_simpL10_qp11_qt6_decompJPEG_712x712_Q50",0.343023255813953,59,2,60,6,127
"rescue_craft","rescue_craft_simpL8_qp10_qt10_decompJPEG_712x712_Q10",0.386904761904763,94,77,72,69,312
"bronzeCat","bronzeCat_simpL1_qp10_qt9_decompJPEG_512x512_Q50",0.146341463414635,70,87,91,81,329
"model_Pastries_20180129_111506950","model_Pastries_20180129_111506950_simpL10_qp11_qt6_decompJPEG_1024x1024_Q75",0.895348837209302,59,45,37,63,204
"Harrison_Front_Parlor_ChairSimplified","Harrison_Front_Parlor_ChairSimplified_simpL9_qp10_qt7_decompJPEG_512x512_Q90",0.727272727272728,82,33,63,31,209
"Harrison_Front_Parlor_ChairSimplified","Harrison_Front_Parlor_ChairSimplified_simpL7_qp11_qt7_decompJPEG_512x512_Q75",0.738372093023255,82,33,63,31,209
"Doryphoros_HighRes_4Mfaces_Simplified_BakedUV","Doryphoros_HighRes_4Mfaces_Simplified_BakedUV_simpL1_qp10_qt6_decompJPEG_1440x1440_Q25",0.848837209302325,25,23,26,23,97
"Emberiza_calandra2","Emberiza_calandra2_simpL10_qp7_qt7_decompJPEG_1440x1440_Q50",0.714285714285715,23,29,22,22,96
"bronzeCat","bronzeCat_simpL10_qp8_qt7_decompJPEG_2048x2048_Q90",0.615853658536585,70,87,91,81,329
"Harrison_Front_Parlor_ChairSimplified","Harrison_Front_Parlor_ChairSimplified_simpL1_qp9_qt10_decompJPEG_1024x1024_Q75",0.34659090909091,82,33,63,31,209
"Harrison_Front_Parlor_ChairSimplified","Harrison_Front_Parlor_ChairSimplified_simpL8_qp11_qt7_decompJPEG_512x512_Q75",0.727272727272728,82,33,63,31,209
"Doryphoros_HighRes_4Mfaces_Simplified_BakedUV","Doryphoros_HighRes_4Mfaces_Simplified_BakedUV_simpL2_qp9_qt10_decompJPEG_512x512_Q25",0.827380952380953,25,23,26,23,97
"bronzeCat","bronzeCat_simpL10_qp8_qt8_decompJPEG_1024x1024_Q90",0.566666666666668,70,87,91,81,329
"Deity_Earring_with_Vishnu_Garuda_and_chepu_100K","Deity_Earring_with_Vishnu_Garuda_and_chepu_100K_simpL8_qp11_qt7_decompJPEG_512x512_Q50",0.30813953488372,60,6,61,8,135
"Elephant_zun_bakedUV","Elephant_zun_bakedUV_simpL9_qp11_qt8_decompJPEG_1440x1440_Q50",0.28125,79,70,90,66,305
"rescue_craft","rescue_craft_simpL9_qp10_qt7_decompJPEG_512x512_Q25",0.517857142857142,94,77,72,69,312
"Deity_Earring_with_Vishnu_Garuda_and_chepu_100K","Deity_Earring_with_Vishnu_Garuda_and_chepu_100K_simpL7_qp11_qt8_decompJPEG_1440x1440_Q50",0.127906976744185,60,6,61,8,135
"rescue_craft","rescue_craft_simpL9_qp10_qt7_decompJPEG_512x512_Q50",0.5,94,77,72,69,312
"Elephant_zun_bakedUV","Elephant_zun_bakedUV_simpL3_qp8_qt10_decompJPEG_512x512_Q75",0.523255813953488,79,70,90,66,305
"model_Pastries_20180129_111506950","model_Pastries_20180129_111506950_simpL10_qp11_qt8_decompJPEG_2048x2048_Q90",0.554878048780488,59,45,37,63,204
"Deity_Earring_with_Vishnu_Garuda_and_chepu_100K","Deity_Earring_with_Vishnu_Garuda_and_chepu_100K_simpL4_qp8_qt10_decompJPEG_512x512_Q10",0.357142857142858,60,6,61,8,135
"Elephant_zun_bakedUV","Elephant_zun_bakedUV_simpL9_qp9_qt10_decompJPEG_2048x2048_Q90",0.19767441860465,79,70,90,66,305
"Doryphoros_HighRes_4Mfaces_Simplified_BakedUV","Doryphoros_HighRes_4Mfaces_Simplified_BakedUV_simpL4_qp9_qt6_decompJPEG_2048x2048_Q90",0.865853658536585,25,23,26,23,97
"Elephant_zun_bakedUV","Elephant_zun_bakedUV_simpL8_qp11_qt6_decompJPEG_2048x2048_Q75",0.81547619047619,79,70,90,66,305
"Harrison_Front_Parlor_ChairSimplified","Harrison_Front_Parlor_ChairSimplified_simpL1_qp8_qt10_decompJPEG_1024x1024_Q50",0.72159090909091,82,33,63,31,209
"ET26_L_MK1","ET26_L_MK1_simpL10_qp11_qt6_decompJPEG_512x512_Q90",0.238095238095237,59,2,60,6,127
"Elephant_zun_bakedUV","Elephant_zun_bakedUV_simpL2_qp10_qt9_decompJPEG_1440x1440_Q25",0.176136363636362,79,70,90,66,305
"Deity_Earring_with_Vishnu_Garuda_and_chepu_100K","Deity_Earring_with_Vishnu_Garuda_and_chepu_100K_simpL9_qp11_qt8_decompJPEG_512x512_Q50",0.178571428571427,60,6,61,8,135
"Elephant_zun_bakedUV","Elephant_zun_bakedUV_simpL9_qp9_qt9_decompJPEG_2048x2048_Q90",0.261627906976745,79,70,90,66,305
"SitzenderKnabeNC","SitzenderKnabeNC_simpL6_qp11_qt10_decompJPEG_1024x1024_Q10",0.25,91,99,103,84,377
"model_Pastries_20180129_111506950","model_Pastries_20180129_111506950_simpL7_qp10_qt10_decompJPEG_712x712_Q25",0.261627906976745,59,45,37,63,204
"bronzeCat","bronzeCat_simpL9_qp11_qt7_decompJPEG_1024x1024_Q75",0.38095238095238,70,87,91,81,329
"rescue_craft","rescue_craft_simpL8_qp11_qt7_decompJPEG_512x512_Q75",0.3875,94,77,72,69,312
"rescue_craft","rescue_craft_simpL2_qp9_qt6_decompJPEG_512x512_Q10",0.664634146341462,94,77,72,69,312
"Harrison_Front_Parlor_ChairSimplified","Harrison_Front_Parlor_ChairSimplified_simpL1_qp10_qt10_decompJPEG_2048x2048_Q50",0.196428571428573,82,33,63,31,209
"rescue_craft","rescue_craft_simpL9_qp10_qt8_decompJPEG_512x512_Q75",0.451219512195122,94,77,72,69,312
"Deity_Earring_with_Vishnu_Garuda_and_chepu_100K","Deity_Earring_with_Vishnu_Garuda_and_chepu_100K_simpL9_qp9_qt9_decompJPEG_712x712_Q90",0.24390243902439,60,6,61,8,135
"Deity_Earring_with_Vishnu_Garuda_and_chepu_100K","Deity_Earring_with_Vishnu_Garuda_and_chepu_100K_simpL2_qp11_qt7_decompJPEG_1440x1440_Q10",0.422619047619047,60,6,61,8,135
"Deity_Earring_with_Vishnu_Garuda_and_chepu_100K","Deity_Earring_with_Vishnu_Garuda_and_chepu_100K_simpL9_qp11_qt6_decompJPEG_1440x1440_Q90",0.60625,60,6,61,8,135
"Deity_Earring_with_Vishnu_Garuda_and_chepu_100K","Deity_Earring_with_Vishnu_Garuda_and_chepu_100K_simpL9_qp7_qt8_decompJPEG_712x712_Q50",0.53125,60,6,61,8,135
"Doryphoros_HighRes_4Mfaces_Simplified_BakedUV","Doryphoros_HighRes_4Mfaces_Simplified_BakedUV_simpL5_qp10_qt6_decompJPEG_1024x1024_Q75",0.80813953488372,25,23,26,23,97
"Deity_Earring_with_Vishnu_Garuda_and_chepu_100K","Deity_Earring_with_Vishnu_Garuda_and_chepu_100K_simpL9_qp9_qt7_decompJPEG_512x512_Q25",0.36904761904762,60,6,61,8,135
"Deity_Earring_with_Vishnu_Garuda_and_chepu_100K","Deity_Earring_with_Vishnu_Garuda_and_chepu_100K_simpL2_qp8_qt10_decompJPEG_512x512_Q10",0.392045454545455,60,6,61,8,135
"Elephant_zun_bakedUV","Elephant_zun_bakedUV_simpL9_qp11_qt8_decompJPEG_2048x2048_Q90",0.244318181818183,79,70,90,66,305
"Deity_Earring_with_Vishnu_Garuda_and_chepu_100K","Deity_Earring_with_Vishnu_Garuda_and_chepu_100K_simpL9_qp8_qt8_decompJPEG_712x712_Q90",0.267441860465118,60,6,61,8,135
"model_Pastries_20180129_111506950","model_Pastries_20180129_111506950_simpL10_qp10_qt6_decompJPEG_2048x2048_Q90",0.833333333333332,59,45,37,63,204
"Emberiza_calandra2","Emberiza_calandra2_simpL10_qp10_qt6_decompJPEG_712x712_Q10",0.55625,23,29,22,22,96
"Deity_Earring_with_Vishnu_Garuda_and_chepu_100K","Deity_Earring_with_Vishnu_Garuda_and_chepu_100K_simpL7_qp9_qt7_decompJPEG_2048x2048_Q25",0.377906976744185,60,6,61,8,135
"Harrison_Front_Parlor_ChairSimplified","Harrison_Front_Parlor_ChairSimplified_simpL8_qp10_qt6_decompJPEG_1024x1024_Q50",0.848837209302325,82,33,63,31,209
"SitzenderKnabeNC","SitzenderKnabeNC_simpL8_qp9_qt6_decompJPEG_2048x2048_Q10",0.686046511627908,91,99,103,84,377
"rescue_craft","rescue_craft_simpL7_qp10_qt6_decompJPEG_512x512_Q25",0.505555555555555,94,77,72,69,312
"ET26_L_MK1","ET26_L_MK1_simpL10_qp8_qt7_decompJPEG_1440x1440_Q90",0.18452380952381,59,2,60,6,127
"Doryphoros_HighRes_4Mfaces_Simplified_BakedUV","Doryphoros_HighRes_4Mfaces_Simplified_BakedUV_simpL4_qp9_qt6_decompJPEG_1440x1440_Q50",0.875,25,23,26,23,97
"bronzeCat","bronzeCat_simpL10_qp8_qt10_decompJPEG_2048x2048_Q90",0.563953488372092,70,87,91,81,329
"Emberiza_calandra2","Emberiza_calandra2_simpL10_qp8_qt7_decompJPEG_712x712_Q25",0.436046511627908,23,29,22,22,96
"model_Pastries_20180129_111506950","model_Pastries_20180129_111506950_simpL9_qp8_qt8_decompJPEG_1440x1440_Q10",0.517045454545455,59,45,37,63,204
"bronzeCat","bronzeCat_simpL10_qp9_qt7_decompJPEG_1440x1440_Q25",0.65909090909091,70,87,91,81,329
"Deity_Earring_with_Vishnu_Garuda_and_chepu_100K","Deity_Earring_with_Vishnu_Garuda_and_chepu_100K_simpL8_qp11_qt7_decompJPEG_2048x2048_Q25",0.291666666666668,60,6,61,8,135
"rescue_craft","rescue_craft_simpL4_qp11_qt9_decompJPEG_712x712_Q10",0.19767441860465,94,77,72,69,312
"Doryphoros_HighRes_4Mfaces_Simplified_BakedUV","Doryphoros_HighRes_4Mfaces_Simplified_BakedUV_simpL4_qp9_qt6_decompJPEG_1024x1024_Q10",0.8875,25,23,26,23,97
"Deity_Earring_with_Vishnu_Garuda_and_chepu_100K","Deity_Earring_with_Vishnu_Garuda_and_chepu_100K_simpL3_qp9_qt9_decompJPEG_712x712_Q10",0.1875,60,6,61,8,135
"Emberiza_calandra2","Emberiza_calandra2_simpL10_qp10_qt6_decompJPEG_1024x1024_Q50",0.53048780487805,23,29,22,22,96
"Elephant_zun_bakedUV","Elephant_zun_bakedUV_simpL3_qp10_qt10_decompJPEG_1024x1024_Q25",0.136904761904763,79,70,90,66,305
"bear","bear_simpL9_qp9_qt9_decompJPEG_712x712_Q50",0.209302325581395,84,54,87,70,295
"Deity_Earring_with_Vishnu_Garuda_and_chepu_100K","Deity_Earring_with_Vishnu_Garuda_and_chepu_100K_simpL6_qp11_qt7_decompJPEG_712x712_Q75",0.351190476190475,60,6,61,8,135
"bronzeCat","bronzeCat_simpL10_qp10_qt10_decompJPEG_1440x1440_Q50",0.571428571428573,70,87,91,81,329
"bear","bear_simpL6_qp9_qt8_decompJPEG_1024x1024_Q25",0.488636363636363,84,54,87,70,295
"model_Pastries_20180129_111506950","model_Pastries_20180129_111506950_simpL10_qp10_qt6_decompJPEG_2048x2048_Q50",0.875,59,45,37,63,204
"bronzeCat","bronzeCat_simpL10_qp10_qt7_decompJPEG_2048x2048_Q50",0.59090909090909,70,87,91,81,329
"Elephant_zun_bakedUV","Elephant_zun_bakedUV_simpL5_qp8_qt10_decompJPEG_1024x1024_Q75",0.482558139534882,79,70,90,66,305
"SitzenderKnabeNC","SitzenderKnabeNC_simpL1_qp11_qt10_decompJPEG_1024x1024_Q10",0.148809523809522,91,99,103,84,377
"Doryphoros_HighRes_4Mfaces_Simplified_BakedUV","Doryphoros_HighRes_4Mfaces_Simplified_BakedUV_simpL1_qp9_qt9_decompJPEG_1440x1440_Q10",0.7875,25,23,26,23,97
"model_Pastries_20180129_111506950","model_Pastries_20180129_111506950_simpL10_qp10_qt7_decompJPEG_2048x2048_Q75",0.693181818181817,59,45,37,63,204
"Harrison_Front_Parlor_ChairSimplified","Harrison_Front_Parlor_ChairSimplified_simpL9_qp8_qt9_decompJPEG_2048x2048_Q90",0.534883720930233,82,33,63,31,209
"bear","bear_simpL6_qp11_qt10_decompJPEG_712x712_Q50",0.122222222222222,84,54,87,70,295
"Elephant_zun_bakedUV","Elephant_zun_bakedUV_simpL7_qp8_qt8_decompJPEG_512x512_Q10",0.693181818181817,79,70,90,66,305
"ET26_L_MK1","ET26_L_MK1_simpL10_qp10_qt7_decompJPEG_1440x1440_Q90",0.174418604651162,59,2,60,6,127
"rescue_craft","rescue_craft_simpL9_qp10_qt7_decompJPEG_1440x1440_Q25",0.529761904761905,94,77,72,69,312
"Harrison_Front_Parlor_ChairSimplified","Harrison_Front_Parlor_ChairSimplified_simpL9_qp9_qt9_decompJPEG_2048x2048_Q75",0.209302325581395,82,33,63,31,209
"ET26_L_MK1","ET26_L_MK1_simpL6_qp9_qt10_decompJPEG_512x512_Q25",0.261904761904763,59,2,60,6,127
"SitzenderKnabeNC","SitzenderKnabeNC_simpL2_qp8_qt8_decompJPEG_2048x2048_Q10",0.715116279069767,91,99,103,84,377
"Deity_Earring_with_Vishnu_Garuda_and_chepu_100K","Deity_Earring_with_Vishnu_Garuda_and_chepu_100K_simpL1_qp10_qt8_decompJPEG_512x512_Q10",0.25625,60,6,61,8,135
"Harrison_Front_Parlor_ChairSimplified","Harrison_Front_Parlor_ChairSimplified_simpL9_qp10_qt8_decompJPEG_1024x1024_Q75",0.363636363636363,82,33,63,31,209
"Doryphoros_HighRes_4Mfaces_Simplified_BakedUV","Doryphoros_HighRes_4Mfaces_Simplified_BakedUV_simpL4_qp7_qt6_decompJPEG_512x512_Q25",0.994318181818183,25,23,26,23,97
"Harrison_Front_Parlor_ChairSimplified","Harrison_Front_Parlor_ChairSimplified_simpL9_qp11_qt7_decompJPEG_1024x1024_Q90",0.720238095238095,82,33,63,31,209
"Harrison_Front_Parlor_ChairSimplified","Harrison_Front_Parlor_ChairSimplified_simpL7_qp8_qt9_decompJPEG_1440x1440_Q75",0.595238095238095,82,33,63,31,209
"Deity_Earring_with_Vishnu_Garuda_and_chepu_100K","Deity_Earring_with_Vishnu_Garuda_and_chepu_100K_simpL9_qp8_qt6_decompJPEG_1024x1024_Q10",0.66860465116279,60,6,61,8,135
"Elephant_zun_bakedUV","Elephant_zun_bakedUV_simpL5_qp10_qt9_decompJPEG_512x512_Q90",0.195121951219513,79,70,90,66,305
"Deity_Earring_with_Vishnu_Garuda_and_chepu_100K","Deity_Earring_with_Vishnu_Garuda_and_chepu_100K_simpL9_qp11_qt6_decompJPEG_2048x2048_Q75",0.616666666666667,60,6,61,8,135
"Doryphoros_HighRes_4Mfaces_Simplified_BakedUV","Doryphoros_HighRes_4Mfaces_Simplified_BakedUV_simpL3_qp10_qt6_decompJPEG_2048x2048_Q75",0.829545454545455,25,23,26,23,97
"Elephant_zun_bakedUV","Elephant_zun_bakedUV_simpL4_qp11_qt10_decompJPEG_512x512_Q90",0.130681818181817,79,70,90,66,305
"SitzenderKnabeNC","SitzenderKnabeNC_simpL4_qp10_qt6_decompJPEG_712x712_Q25",0.622093023255815,91,99,103,84,377
"SitzenderKnabeNC","SitzenderKnabeNC_simpL5_qp11_qt10_decompJPEG_1024x1024_Q10",0.27840909090909,91,99,103,84,377
"model_Pastries_20180129_111506950","model_Pastries_20180129_111506950_simpL1_qp8_qt9_decompJPEG_712x712_Q50",0.49390243902439,59,45,37,63,204
"SitzenderKnabeNC","SitzenderKnabeNC_simpL7_qp11_qt8_decompJPEG_512x512_Q10",0.404761904761905,91,99,103,84,377
"model_Pastries_20180129_111506950","model_Pastries_20180129_111506950_simpL10_qp9_qt10_decompJPEG_2048x2048_Q50",0.648809523809525,59,45,37,63,204
"Elephant_zun_bakedUV","Elephant_zun_bakedUV_simpL2_qp11_qt10_decompJPEG_512x512_Q90",0.145348837209303,79,70,90,66,305
"bronzeCat","bronzeCat_simpL2_qp10_qt10_decompJPEG_2048x2048_Q10",0.16860465116279,70,87,91,81,329
"rescue_craft","rescue_craft_simpL4_qp9_qt7_decompJPEG_1024x1024_Q50",0.69375,94,77,72,69,312
"model_Pastries_20180129_111506950","model_Pastries_20180129_111506950_simpL9_qp10_qt6_decompJPEG_512x512_Q50",0.946428571428573,59,45,37,63,204
"Harrison_Front_Parlor_ChairSimplified","Harrison_Front_Parlor_ChairSimplified_simpL2_qp10_qt10_decompJPEG_1024x1024_Q75",0.142857142857143,82,33,63,31,209
"Harrison_Front_Parlor_ChairSimplified","Harrison_Front_Parlor_ChairSimplified_simpL9_qp11_qt7_decompJPEG_512x512_Q75",0.7,82,33,63,31,209
"SitzenderKnabeNC","SitzenderKnabeNC_simpL3_qp11_qt6_decompJPEG_512x512_Q50",0.605555555555555,91,99,103,84,377
"model_Pastries_20180129_111506950","model_Pastries_20180129_111506950_simpL5_qp10_qt8_decompJPEG_2048x2048_Q50",0.306818181818183,59,45,37,63,204
"model_Pastries_20180129_111506950","model_Pastries_20180129_111506950_simpL2_qp8_qt10_decompJPEG_512x512_Q75",0.482954545454545,59,45,37,63,204
