"Model","stimulus","MOS","VP1","VP2","VP3","VP4","TotalPatches"
"Beethoven_bakedUV2","Beethoven_bakedUV2_simpL10_qp7_qt6_decompJPEG_712x712_Q10",0.946428571428573,44,40,44,39,167
"TimeWarner_SA_remote","TimeWarner_SA_remote_simpL4_qp10_qt6_decompJPEG_1440x1440_Q10",0.857142857142857,53,29,50,28,160
"Jomon_bakedUV","Jomon_bakedUV_simpL2_qp11_qt6_decompJPEG_2048x2048_Q90",0.68125,71,73,86,70,300
"to_subs","to_subs_simpL3_qp8_qt10_decompJPEG_512x512_Q10",0.790697674418605,15,0,22,0,37
"to_subs","to_subs_simpL9_qp7_qt6_decompJPEG_712x712_Q50",0.952380952380953,15,0,22,0,37
"dom_utka","dom_utka_simpL10_qp10_qt6_decompJPEG_2048x2048_Q75",0.609756097560975,45,31,45,27,148
"Ailurodus_maculosus","Ailurodus_maculosus_simpL2_qp10_qt6_decompJPEG_512x512_Q10",0.666666666666668,50,47,48,47,192
"Jomon_bakedUV","Jomon_bakedUV_simpL6_qp11_qt7_decompJPEG_2048x2048_Q25",0.375,71,73,86,70,300
"CharlieChaplin","CharlieChaplin_simpL10_qp7_qt6_decompJPEG_1024x1024_Q25",0.926829268292682,37,32,42,19,130
"1970.16_Neck_Amphora_100K","1970.16_Neck_Amphora_100K_simpL10_qp9_qt9_decompJPEG_1024x1024_Q75",0.3125,72,77,86,78,313
"abel_highpoly_meshexp","abel_highpoly_meshexp_simpL9_qp10_qt6_decompJPEG_1440x1440_Q25",0.463414634146343,30,24,20,16,90
"sylvaniapathmaker","sylvaniapathmaker_simpL2_qp8_qt10_decompJPEG_2048x2048_Q25",0.546511627906977,81,65,84,68,298
"piano","piano_simpL1_qp9_qt7_decompJPEG_2048x2048_Q50",0.267441860465118,109,90,148,90,437
"abel_highpoly_meshexp","abel_highpoly_meshexp_simpL3_qp11_qt6_decompJPEG_712x712_Q50",0.443181818181817,30,24,20,16,90
"1970.16_Neck_Amphora_100K","1970.16_Neck_Amphora_100K_simpL10_qp10_qt9_decompJPEG_1024x1024_Q75",0.303571428571427,72,77,86,78,313
"Jomon_bakedUV","Jomon_bakedUV_simpL3_qp8_qt9_decompJPEG_1024x1024_Q90",0.505555555555555,71,73,86,70,300
"abel_highpoly_meshexp","abel_highpoly_meshexp_simpL3_qp9_qt6_decompJPEG_2048x2048_Q25",0.452380952380953,30,24,20,16,90
"Beethoven_bakedUV2","Beethoven_bakedUV2_simpL8_qp11_qt10_decompJPEG_2048x2048_Q25",0.172222222222222,44,40,44,39,167
"Ailurodus_maculosus","Ailurodus_maculosus_simpL7_qp8_qt10_decompJPEG_2048x2048_Q25",0.55625,50,47,48,47,192
"abel_highpoly_meshexp","abel_highpoly_meshexp_simpL7_qp9_qt6_decompJPEG_712x712_Q90",0.513157894736842,30,24,20,16,90
"abel_highpoly_meshexp","abel_highpoly_meshexp_simpL7_qp10_qt6_decompJPEG_712x712_Q50",0.480263157894738,30,24,20,16,90
"dom_utka","dom_utka_simpL1_qp7_qt7_decompJPEG_512x512_Q10",0.880681818181817,45,31,45,27,148
"piano","piano_simpL9_qp9_qt7_decompJPEG_1440x1440_Q25",0.36046511627907,109,90,148,90,437
"Beethoven_bakedUV2","Beethoven_bakedUV2_simpL3_qp9_qt9_decompJPEG_512x512_Q75",0.536585365853657,44,40,44,39,167
"dom_utka","dom_utka_simpL7_qp8_qt9_decompJPEG_1024x1024_Q10",0.55,45,31,45,27,148
"1970.16_Neck_Amphora_100K","1970.16_Neck_Amphora_100K_simpL10_qp8_qt7_decompJPEG_1024x1024_Q90",0.354651162790698,72,77,86,78,313
"dom_utka","dom_utka_simpL4_qp7_qt6_decompJPEG_512x512_Q50",0.931818181818183,45,31,45,27,148
"Beethoven_bakedUV2","Beethoven_bakedUV2_simpL10_qp7_qt10_decompJPEG_2048x2048_Q75",0.920731707317072,44,40,44,39,167
"CharlieChaplin","CharlieChaplin_simpL9_qp8_qt10_decompJPEG_512x512_Q25",0.7875,37,32,42,19,130
"to_subs","to_subs_simpL10_qp11_qt8_decompJPEG_1024x1024_Q75",0.961538461538463,15,0,22,0,37
"sylvaniapathmaker","sylvaniapathmaker_simpL10_qp9_qt9_decompJPEG_2048x2048_Q75",0.625,81,65,84,68,298
"Beethoven_bakedUV2","Beethoven_bakedUV2_simpL5_qp8_qt8_decompJPEG_712x712_Q10",0.801136363636362,44,40,44,39,167
"Ailurodus_maculosus","Ailurodus_maculosus_simpL9_qp9_qt7_decompJPEG_712x712_Q50",0.416666666666668,50,47,48,47,192
"piano","piano_simpL7_qp10_qt7_decompJPEG_712x712_Q90",0.289473684210528,109,90,148,90,437
"abel_highpoly_meshexp","abel_highpoly_meshexp_simpL3_qp8_qt10_decompJPEG_1024x1024_Q90",0.587209302325583,30,24,20,16,90
"CharlieChaplin","CharlieChaplin_simpL2_qp10_qt6_decompJPEG_512x512_Q10",0.68452380952381,37,32,42,19,130
"TimeWarner_SA_remote","TimeWarner_SA_remote_simpL9_qp11_qt6_decompJPEG_2048x2048_Q75",0.791666666666668,53,29,50,28,160
"CharlieChaplin","CharlieChaplin_simpL9_qp10_qt6_decompJPEG_512x512_Q75",0.680232558139535,37,32,42,19,130
"abel_highpoly_meshexp","abel_highpoly_meshexp_simpL10_qp7_qt7_decompJPEG_1024x1024_Q50",0.494318181818183,30,24,20,16,90
"Jomon_bakedUV","Jomon_bakedUV_simpL8_qp10_qt9_decompJPEG_712x712_Q10",0.511904761904763,71,73,86,70,300
"CharlieChaplin","CharlieChaplin_simpL9_qp10_qt6_decompJPEG_712x712_Q50",0.75609756097561,37,32,42,19,130
"1970.16_Neck_Amphora_100K","1970.16_Neck_Amphora_100K_simpL1_qp11_qt10_decompJPEG_512x512_Q50",0.14375,72,77,86,78,313
"to_subs","to_subs_simpL8_qp8_qt10_decompJPEG_1024x1024_Q25",0.783333333333333,15,0,22,0,37
"dom_utka","dom_utka_simpL10_qp7_qt7_decompJPEG_2048x2048_Q90",0.601190476190475,45,31,45,27,148
"dom_utka","dom_utka_simpL3_qp8_qt7_decompJPEG_512x512_Q75",0.54375,45,31,45,27,148
"sylvaniapathmaker","sylvaniapathmaker_simpL1_qp8_qt9_decompJPEG_1440x1440_Q25",0.595238095238095,81,65,84,68,298
"TimeWarner_SA_remote","TimeWarner_SA_remote_simpL8_qp11_qt6_decompJPEG_512x512_Q75",0.88953488372093,53,29,50,28,160
"piano","piano_simpL5_qp10_qt7_decompJPEG_1024x1024_Q90",0.238372093023255,109,90,148,90,437
"Ailurodus_maculosus","Ailurodus_maculosus_simpL8_qp8_qt8_decompJPEG_1440x1440_Q90",0.595238095238095,50,47,48,47,192
"1970.16_Neck_Amphora_100K","1970.16_Neck_Amphora_100K_simpL9_qp9_qt7_decompJPEG_1024x1024_Q90",0.33888888888889,72,77,86,78,313
"Ailurodus_maculosus","Ailurodus_maculosus_simpL8_qp9_qt9_decompJPEG_512x512_Q25",0.313953488372092,50,47,48,47,192
"TimeWarner_SA_remote","TimeWarner_SA_remote_simpL8_qp11_qt6_decompJPEG_1440x1440_Q75",0.797619047619047,53,29,50,28,160
"Beethoven_bakedUV2","Beethoven_bakedUV2_simpL10_qp11_qt6_decompJPEG_712x712_Q10",0.936046511627908,44,40,44,39,167
"Ailurodus_maculosus","Ailurodus_maculosus_simpL7_qp8_qt10_decompJPEG_1440x1440_Q25",0.589285714285715,50,47,48,47,192
"dom_utka","dom_utka_simpL10_qp7_qt6_decompJPEG_1440x1440_Q10",0.664473684210528,45,31,45,27,148
"sylvaniapathmaker","sylvaniapathmaker_simpL4_qp8_qt9_decompJPEG_2048x2048_Q10",0.538461538461538,81,65,84,68,298
"CharlieChaplin","CharlieChaplin_simpL9_qp11_qt6_decompJPEG_512x512_Q25",0.767441860465117,37,32,42,19,130
"sylvaniapathmaker","sylvaniapathmaker_simpL1_qp8_qt9_decompJPEG_512x512_Q90",0.55,81,65,84,68,298
"piano","piano_simpL6_qp11_qt7_decompJPEG_712x712_Q90",0.23076923076923,109,90,148,90,437
"Beethoven_bakedUV2","Beethoven_bakedUV2_simpL1_qp9_qt7_decompJPEG_1440x1440_Q50",0.61046511627907,44,40,44,39,167
"dom_utka","dom_utka_simpL1_qp10_qt8_decompJPEG_1024x1024_Q10",0.204545454545455,45,31,45,27,148
"TimeWarner_SA_remote","TimeWarner_SA_remote_simpL2_qp9_qt6_decompJPEG_1440x1440_Q10",0.895348837209302,53,29,50,28,160
"Ailurodus_maculosus","Ailurodus_maculosus_simpL9_qp11_qt7_decompJPEG_1440x1440_Q90",0.3125,50,47,48,47,192
"Jomon_bakedUV","Jomon_bakedUV_simpL7_qp10_qt7_decompJPEG_2048x2048_Q10",0.444444444444445,71,73,86,70,300
"to_subs","to_subs_simpL9_qp7_qt10_decompJPEG_2048x2048_Q10",0.94767441860465,15,0,22,0,37
"CharlieChaplin","CharlieChaplin_simpL4_qp8_qt10_decompJPEG_2048x2048_Q75",0.886904761904763,37,32,42,19,130
"abel_highpoly_meshexp","abel_highpoly_meshexp_simpL7_qp8_qt9_decompJPEG_2048x2048_Q50",0.482954545454545,30,24,20,16,90
"piano","piano_simpL6_qp11_qt7_decompJPEG_1024x1024_Q75",0.238372093023255,109,90,148,90,437
"Jomon_bakedUV","Jomon_bakedUV_simpL10_qp7_qt9_decompJPEG_1440x1440_Q50",0.914772727272728,71,73,86,70,300
"Jomon_bakedUV","Jomon_bakedUV_simpL5_qp10_qt7_decompJPEG_512x512_Q10",0.46590909090909,71,73,86,70,300
"dom_utka","dom_utka_simpL4_qp7_qt6_decompJPEG_512x512_Q75",0.901162790697675,45,31,45,27,148
"Jomon_bakedUV","Jomon_bakedUV_simpL9_qp9_qt8_decompJPEG_512x512_Q25",0.53409090909091,71,73,86,70,300
"Jomon_bakedUV","Jomon_bakedUV_simpL7_qp10_qt10_decompJPEG_712x712_Q25",0.227272727272728,71,73,86,70,300
"Ailurodus_maculosus","Ailurodus_maculosus_simpL2_qp10_qt7_decompJPEG_1024x1024_Q25",0.476744186046512,50,47,48,47,192
"sylvaniapathmaker","sylvaniapathmaker_simpL7_qp9_qt7_decompJPEG_512x512_Q90",0.672619047619047,81,65,84,68,298
"piano","piano_simpL1_qp10_qt7_decompJPEG_1024x1024_Q25",0.211538461538463,109,90,148,90,437
"1970.16_Neck_Amphora_100K","1970.16_Neck_Amphora_100K_simpL10_qp10_qt10_decompJPEG_2048x2048_Q50",0.297619047619047,72,77,86,78,313
"Ailurodus_maculosus","Ailurodus_maculosus_simpL1_qp10_qt7_decompJPEG_1440x1440_Q50",0.460227272727272,50,47,48,47,192
"sylvaniapathmaker","sylvaniapathmaker_simpL10_qp8_qt9_decompJPEG_1024x1024_Q90",0.625,81,65,84,68,298
"1970.16_Neck_Amphora_100K","1970.16_Neck_Amphora_100K_simpL10_qp9_qt6_decompJPEG_1440x1440_Q50",0.430232558139535,72,77,86,78,313
"CharlieChaplin","CharlieChaplin_simpL3_qp11_qt7_decompJPEG_512x512_Q90",0.395348837209302,37,32,42,19,130
"Jomon_bakedUV","Jomon_bakedUV_simpL1_qp11_qt6_decompJPEG_2048x2048_Q90",0.738636363636363,71,73,86,70,300
"to_subs","to_subs_simpL6_qp10_qt7_decompJPEG_712x712_Q75",0.216666666666667,15,0,22,0,37
"Jomon_bakedUV","Jomon_bakedUV_simpL5_qp10_qt6_decompJPEG_2048x2048_Q90",0.69186046511628,71,73,86,70,300
"Jomon_bakedUV","Jomon_bakedUV_simpL5_qp11_qt6_decompJPEG_2048x2048_Q90",0.698863636363637,71,73,86,70,300
"piano","piano_simpL9_qp8_qt6_decompJPEG_2048x2048_Q75",0.453488372093023,109,90,148,90,437
"Beethoven_bakedUV2","Beethoven_bakedUV2_simpL10_qp10_qt10_decompJPEG_512x512_Q10",0.825,44,40,44,39,167
"dom_utka","dom_utka_simpL10_qp8_qt6_decompJPEG_712x712_Q75",0.534883720930233,45,31,45,27,148
"TimeWarner_SA_remote","TimeWarner_SA_remote_simpL1_qp10_qt6_decompJPEG_1440x1440_Q10",0.877906976744185,53,29,50,28,160
"piano","piano_simpL5_qp11_qt7_decompJPEG_1440x1440_Q50",0.238095238095237,109,90,148,90,437
"Ailurodus_maculosus","Ailurodus_maculosus_simpL9_qp11_qt7_decompJPEG_1024x1024_Q90",0.414634146341462,50,47,48,47,192
"abel_highpoly_meshexp","abel_highpoly_meshexp_simpL7_qp9_qt6_decompJPEG_512x512_Q90",0.432926829268293,30,24,20,16,90
"TimeWarner_SA_remote","TimeWarner_SA_remote_simpL4_qp10_qt6_decompJPEG_512x512_Q25",0.84375,53,29,50,28,160
"to_subs","to_subs_simpL9_qp7_qt6_decompJPEG_712x712_Q75",0.927777777777777,15,0,22,0,37
"TimeWarner_SA_remote","TimeWarner_SA_remote_simpL8_qp10_qt6_decompJPEG_1024x1024_Q50",0.854651162790698,53,29,50,28,160
"to_subs","to_subs_simpL8_qp9_qt6_decompJPEG_512x512_Q75",0.294444444444445,15,0,22,0,37
"abel_highpoly_meshexp","abel_highpoly_meshexp_simpL4_qp9_qt6_decompJPEG_2048x2048_Q25",0.422619047619047,30,24,20,16,90
"TimeWarner_SA_remote","TimeWarner_SA_remote_simpL1_qp10_qt6_decompJPEG_2048x2048_Q75",0.822222222222223,53,29,50,28,160
"Ailurodus_maculosus","Ailurodus_maculosus_simpL10_qp9_qt10_decompJPEG_1440x1440_Q75",0.386363636363637,50,47,48,47,192
"CharlieChaplin","CharlieChaplin_simpL9_qp8_qt6_decompJPEG_512x512_Q75",0.818181818181817,37,32,42,19,130
"TimeWarner_SA_remote","TimeWarner_SA_remote_simpL7_qp11_qt6_decompJPEG_1440x1440_Q90",0.872093023255815,53,29,50,28,160
"sylvaniapathmaker","sylvaniapathmaker_simpL9_qp10_qt8_decompJPEG_1440x1440_Q75",0.55921052631579,81,65,84,68,298
"dom_utka","dom_utka_simpL9_qp9_qt7_decompJPEG_1024x1024_Q75",0.238372093023255,45,31,45,27,148
"CharlieChaplin","CharlieChaplin_simpL10_qp10_qt6_decompJPEG_1024x1024_Q75",0.958333333333332,37,32,42,19,130
"TimeWarner_SA_remote","TimeWarner_SA_remote_simpL8_qp11_qt6_decompJPEG_712x712_Q75",0.817073170731707,53,29,50,28,160
"abel_highpoly_meshexp","abel_highpoly_meshexp_simpL7_qp8_qt9_decompJPEG_712x712_Q25",0.546511627906977,30,24,20,16,90
"sylvaniapathmaker","sylvaniapathmaker_simpL10_qp10_qt7_decompJPEG_2048x2048_Q75",0.676136363636363,81,65,84,68,298
"CharlieChaplin","CharlieChaplin_simpL10_qp8_qt6_decompJPEG_512x512_Q25",0.93888888888889,37,32,42,19,130
"Ailurodus_maculosus","Ailurodus_maculosus_simpL5_qp10_qt7_decompJPEG_712x712_Q75",0.416666666666668,50,47,48,47,192
"piano","piano_simpL7_qp10_qt7_decompJPEG_2048x2048_Q50",0.170731707317072,109,90,148,90,437
"1970.16_Neck_Amphora_100K","1970.16_Neck_Amphora_100K_simpL10_qp10_qt7_decompJPEG_1024x1024_Q75",0.357142857142858,72,77,86,78,313
"abel_highpoly_meshexp","abel_highpoly_meshexp_simpL9_qp10_qt6_decompJPEG_1440x1440_Q75",0.420454545454545,30,24,20,16,90
"to_subs","to_subs_simpL8_qp7_qt10_decompJPEG_512x512_Q10",0.97159090909091,15,0,22,0,37
"Ailurodus_maculosus","Ailurodus_maculosus_simpL6_qp9_qt10_decompJPEG_2048x2048_Q10",0.33139534883721,50,47,48,47,192
"CharlieChaplin","CharlieChaplin_simpL5_qp8_qt10_decompJPEG_512x512_Q50",0.819767441860465,37,32,42,19,130
"Jomon_bakedUV","Jomon_bakedUV_simpL1_qp11_qt7_decompJPEG_1440x1440_Q90",0.366279069767443,71,73,86,70,300
"Ailurodus_maculosus","Ailurodus_maculosus_simpL2_qp11_qt6_decompJPEG_512x512_Q25",0.662790697674417,50,47,48,47,192
"CharlieChaplin","CharlieChaplin_simpL9_qp11_qt6_decompJPEG_512x512_Q90",0.726190476190475,37,32,42,19,130
"CharlieChaplin","CharlieChaplin_simpL7_qp10_qt6_decompJPEG_1440x1440_Q50",0.672222222222222,37,32,42,19,130
"dom_utka","dom_utka_simpL4_qp7_qt6_decompJPEG_1440x1440_Q75",0.91860465116279,45,31,45,27,148
"dom_utka","dom_utka_simpL4_qp10_qt8_decompJPEG_712x712_Q50",0.227272727272728,45,31,45,27,148
"TimeWarner_SA_remote","TimeWarner_SA_remote_simpL7_qp11_qt6_decompJPEG_712x712_Q90",0.80813953488372,53,29,50,28,160
"piano","piano_simpL6_qp11_qt7_decompJPEG_2048x2048_Q75",0.232558139534883,109,90,148,90,437
"piano","piano_simpL8_qp10_qt7_decompJPEG_2048x2048_Q50",0.22159090909091,109,90,148,90,437
"dom_utka","dom_utka_simpL10_qp7_qt6_decompJPEG_712x712_Q50",0.602272727272728,45,31,45,27,148
"Ailurodus_maculosus","Ailurodus_maculosus_simpL6_qp9_qt10_decompJPEG_712x712_Q75",0.305555555555555,50,47,48,47,192
"dom_utka","dom_utka_simpL1_qp9_qt8_decompJPEG_1024x1024_Q10",0.30232558139535,45,31,45,27,148
"1970.16_Neck_Amphora_100K","1970.16_Neck_Amphora_100K_simpL4_qp11_qt10_decompJPEG_512x512_Q25",0.27906976744186,72,77,86,78,313
"TimeWarner_SA_remote","TimeWarner_SA_remote_simpL3_qp9_qt9_decompJPEG_1440x1440_Q50",0.577777777777778,53,29,50,28,160
"CharlieChaplin","CharlieChaplin_simpL10_qp8_qt6_decompJPEG_1024x1024_Q25",0.922222222222222,37,32,42,19,130
"sylvaniapathmaker","sylvaniapathmaker_simpL1_qp11_qt6_decompJPEG_712x712_Q25",0.75,81,65,84,68,298
"abel_highpoly_meshexp","abel_highpoly_meshexp_simpL7_qp9_qt6_decompJPEG_2048x2048_Q75",0.430232558139535,30,24,20,16,90
"piano","piano_simpL7_qp10_qt7_decompJPEG_712x712_Q50",0.19375,109,90,148,90,437
"sylvaniapathmaker","sylvaniapathmaker_simpL9_qp7_qt10_decompJPEG_1440x1440_Q75",0.726190476190475,81,65,84,68,298
"Beethoven_bakedUV2","Beethoven_bakedUV2_simpL5_qp8_qt9_decompJPEG_1440x1440_Q10",0.773255813953488,44,40,44,39,167
"abel_highpoly_meshexp","abel_highpoly_meshexp_simpL2_qp8_qt8_decompJPEG_1024x1024_Q50",0.547619047619047,30,24,20,16,90
"to_subs","to_subs_simpL9_qp8_qt7_decompJPEG_512x512_Q10",0.75,15,0,22,0,37
"1970.16_Neck_Amphora_100K","1970.16_Neck_Amphora_100K_simpL10_qp10_qt9_decompJPEG_2048x2048_Q90",0.321428571428573,72,77,86,78,313
"TimeWarner_SA_remote","TimeWarner_SA_remote_simpL7_qp11_qt6_decompJPEG_512x512_Q75",0.83139534883721,53,29,50,28,160
"to_subs","to_subs_simpL8_qp7_qt6_decompJPEG_1440x1440_Q75",0.946428571428573,15,0,22,0,37
"CharlieChaplin","CharlieChaplin_simpL10_qp10_qt8_decompJPEG_512x512_Q25",0.927777777777777,37,32,42,19,130
"dom_utka","dom_utka_simpL10_qp9_qt10_decompJPEG_712x712_Q75",0.452380952380953,45,31,45,27,148
"Beethoven_bakedUV2","Beethoven_bakedUV2_simpL10_qp7_qt6_decompJPEG_1024x1024_Q10",0.922619047619047,44,40,44,39,167
"CharlieChaplin","CharlieChaplin_simpL10_qp8_qt6_decompJPEG_2048x2048_Q25",0.916666666666668,37,32,42,19,130
"piano","piano_simpL8_qp11_qt7_decompJPEG_1024x1024_Q75",0.272222222222222,109,90,148,90,437
"CharlieChaplin","CharlieChaplin_simpL6_qp8_qt10_decompJPEG_2048x2048_Q25",0.78048780487805,37,32,42,19,130
"1970.16_Neck_Amphora_100K","1970.16_Neck_Amphora_100K_simpL10_qp11_qt7_decompJPEG_1024x1024_Q90",0.261627906976745,72,77,86,78,313
"Jomon_bakedUV","Jomon_bakedUV_simpL4_qp9_qt7_decompJPEG_512x512_Q75",0.36875,71,73,86,70,300
"piano","piano_simpL6_qp10_qt7_decompJPEG_712x712_Q75",0.23780487804878,109,90,148,90,437
"Jomon_bakedUV","Jomon_bakedUV_simpL1_qp10_qt6_decompJPEG_2048x2048_Q90",0.69767441860465,71,73,86,70,300
"piano","piano_simpL1_qp9_qt7_decompJPEG_1024x1024_Q75",0.285714285714285,109,90,148,90,437
"piano","piano_simpL1_qp11_qt7_decompJPEG_712x712_Q75",0.21951219512195,109,90,148,90,437
"abel_highpoly_meshexp","abel_highpoly_meshexp_simpL1_qp9_qt6_decompJPEG_2048x2048_Q25",0.452380952380953,30,24,20,16,90
"piano","piano_simpL7_qp11_qt7_decompJPEG_1024x1024_Q25",0.15909090909091,109,90,148,90,437
"TimeWarner_SA_remote","TimeWarner_SA_remote_simpL8_qp11_qt6_decompJPEG_2048x2048_Q75",0.877906976744185,53,29,50,28,160
"to_subs","to_subs_simpL9_qp7_qt8_decompJPEG_1024x1024_Q25",0.875,15,0,22,0,37
"to_subs","to_subs_simpL8_qp7_qt7_decompJPEG_512x512_Q10",0.943181818181817,15,0,22,0,37
"dom_utka","dom_utka_simpL4_qp7_qt6_decompJPEG_512x512_Q90",0.960227272727272,45,31,45,27,148
"abel_highpoly_meshexp","abel_highpoly_meshexp_simpL1_qp9_qt6_decompJPEG_512x512_Q50",0.43452380952381,30,24,20,16,90
"to_subs","to_subs_simpL5_qp9_qt6_decompJPEG_512x512_Q25",0.255813953488373,15,0,22,0,37
"CharlieChaplin","CharlieChaplin_simpL10_qp11_qt6_decompJPEG_512x512_Q25",0.963414634146343,37,32,42,19,130
"piano","piano_simpL2_qp9_qt7_decompJPEG_2048x2048_Q90",0.244444444444445,109,90,148,90,437
"dom_utka","dom_utka_simpL4_qp7_qt6_decompJPEG_712x712_Q90",0.886363636363638,45,31,45,27,148
"TimeWarner_SA_remote","TimeWarner_SA_remote_simpL8_qp11_qt6_decompJPEG_512x512_Q90",0.80813953488372,53,29,50,28,160
"piano","piano_simpL1_qp11_qt7_decompJPEG_1024x1024_Q25",0.238636363636362,109,90,148,90,437
"TimeWarner_SA_remote","TimeWarner_SA_remote_simpL8_qp8_qt6_decompJPEG_2048x2048_Q75",0.94186046511628,53,29,50,28,160
"Beethoven_bakedUV2","Beethoven_bakedUV2_simpL10_qp10_qt6_decompJPEG_1440x1440_Q90",0.914634146341462,44,40,44,39,167
"sylvaniapathmaker","sylvaniapathmaker_simpL10_qp10_qt9_decompJPEG_1440x1440_Q10",0.602272727272728,81,65,84,68,298
"dom_utka","dom_utka_simpL1_qp9_qt8_decompJPEG_2048x2048_Q10",0.372093023255815,45,31,45,27,148
"1970.16_Neck_Amphora_100K","1970.16_Neck_Amphora_100K_simpL10_qp9_qt6_decompJPEG_2048x2048_Q75",0.41860465116279,72,77,86,78,313
"Jomon_bakedUV","Jomon_bakedUV_simpL3_qp10_qt6_decompJPEG_2048x2048_Q90",0.627906976744185,71,73,86,70,300
"abel_highpoly_meshexp","abel_highpoly_meshexp_simpL7_qp8_qt10_decompJPEG_512x512_Q90",0.589285714285715,30,24,20,16,90
"to_subs","to_subs_simpL9_qp8_qt6_decompJPEG_1024x1024_Q25",0.713414634146343,15,0,22,0,37
"piano","piano_simpL1_qp10_qt7_decompJPEG_2048x2048_Q50",0.24375,109,90,148,90,437
"CharlieChaplin","CharlieChaplin_simpL1_qp10_qt6_decompJPEG_712x712_Q75",0.56547619047619,37,32,42,19,130
"sylvaniapathmaker","sylvaniapathmaker_simpL10_qp8_qt8_decompJPEG_1024x1024_Q90",0.622093023255815,81,65,84,68,298
"Beethoven_bakedUV2","Beethoven_bakedUV2_simpL10_qp7_qt6_decompJPEG_2048x2048_Q10",0.943181818181817,44,40,44,39,167
"TimeWarner_SA_remote","TimeWarner_SA_remote_simpL8_qp11_qt6_decompJPEG_712x712_Q90",0.84375,53,29,50,28,160
"piano","piano_simpL3_qp10_qt7_decompJPEG_1440x1440_Q25",0.244444444444445,109,90,148,90,437
"piano","piano_simpL9_qp11_qt7_decompJPEG_512x512_Q25",0.337209302325583,109,90,148,90,437
"abel_highpoly_meshexp","abel_highpoly_meshexp_simpL3_qp10_qt6_decompJPEG_1440x1440_Q50",0.45625,30,24,20,16,90
"1970.16_Neck_Amphora_100K","1970.16_Neck_Amphora_100K_simpL10_qp10_qt7_decompJPEG_1440x1440_Q75",0.444444444444445,72,77,86,78,313
"abel_highpoly_meshexp","abel_highpoly_meshexp_simpL10_qp7_qt7_decompJPEG_1024x1024_Q90",0.390243902439025,30,24,20,16,90
"sylvaniapathmaker","sylvaniapathmaker_simpL3_qp9_qt8_decompJPEG_512x512_Q25",0.525,81,65,84,68,298
"1970.16_Neck_Amphora_100K","1970.16_Neck_Amphora_100K_simpL2_qp11_qt10_decompJPEG_512x512_Q50",0.122093023255815,72,77,86,78,313
"to_subs","to_subs_simpL8_qp7_qt10_decompJPEG_2048x2048_Q25",0.958333333333332,15,0,22,0,37
"Beethoven_bakedUV2","Beethoven_bakedUV2_simpL10_qp7_qt6_decompJPEG_512x512_Q10",0.892045454545455,44,40,44,39,167
"1970.16_Neck_Amphora_100K","1970.16_Neck_Amphora_100K_simpL10_qp10_qt9_decompJPEG_1024x1024_Q90",0.321428571428573,72,77,86,78,313
"CharlieChaplin","CharlieChaplin_simpL8_qp11_qt6_decompJPEG_512x512_Q75",0.703488372093023,37,32,42,19,130
"TimeWarner_SA_remote","TimeWarner_SA_remote_simpL7_qp10_qt6_decompJPEG_512x512_Q90",0.855263157894738,53,29,50,28,160
"Ailurodus_maculosus","Ailurodus_maculosus_simpL6_qp9_qt9_decompJPEG_1440x1440_Q25",0.28125,50,47,48,47,192
"TimeWarner_SA_remote","TimeWarner_SA_remote_simpL1_qp11_qt6_decompJPEG_712x712_Q90",0.85,53,29,50,28,160
"piano","piano_simpL9_qp9_qt6_decompJPEG_1440x1440_Q90",0.476744186046512,109,90,148,90,437
"dom_utka","dom_utka_simpL2_qp8_qt10_decompJPEG_712x712_Q50",0.476744186046512,45,31,45,27,148
"Beethoven_bakedUV2","Beethoven_bakedUV2_simpL10_qp10_qt6_decompJPEG_2048x2048_Q75",0.916666666666668,44,40,44,39,167
"CharlieChaplin","CharlieChaplin_simpL10_qp9_qt6_decompJPEG_712x712_Q10",0.884146341463415,37,32,42,19,130
"piano","piano_simpL6_qp10_qt7_decompJPEG_2048x2048_Q50",0.193181818181817,109,90,148,90,437
"Ailurodus_maculosus","Ailurodus_maculosus_simpL2_qp10_qt6_decompJPEG_512x512_Q25",0.65340909090909,50,47,48,47,192
"TimeWarner_SA_remote","TimeWarner_SA_remote_simpL4_qp11_qt6_decompJPEG_712x712_Q50",0.875,53,29,50,28,160
"dom_utka","dom_utka_simpL2_qp11_qt8_decompJPEG_2048x2048_Q10",0.196428571428573,45,31,45,27,148
"abel_highpoly_meshexp","abel_highpoly_meshexp_simpL3_qp8_qt10_decompJPEG_1440x1440_Q50",0.6,30,24,20,16,90
"Ailurodus_maculosus","Ailurodus_maculosus_simpL7_qp11_qt10_decompJPEG_712x712_Q50",0.0988372093023251,50,47,48,47,192
"Beethoven_bakedUV2","Beethoven_bakedUV2_simpL8_qp10_qt6_decompJPEG_1024x1024_Q10",0.74404761904762,44,40,44,39,167
"sylvaniapathmaker","sylvaniapathmaker_simpL10_qp10_qt7_decompJPEG_1024x1024_Q90",0.622093023255815,81,65,84,68,298
"abel_highpoly_meshexp","abel_highpoly_meshexp_simpL7_qp9_qt6_decompJPEG_712x712_Q50",0.51875,30,24,20,16,90
"TimeWarner_SA_remote","TimeWarner_SA_remote_simpL7_qp11_qt6_decompJPEG_512x512_Q90",0.848837209302325,53,29,50,28,160
"1970.16_Neck_Amphora_100K","1970.16_Neck_Amphora_100K_simpL10_qp10_qt7_decompJPEG_2048x2048_Q90",0.386904761904763,72,77,86,78,313
"sylvaniapathmaker","sylvaniapathmaker_simpL10_qp10_qt9_decompJPEG_1024x1024_Q90",0.625,81,65,84,68,298
"TimeWarner_SA_remote","TimeWarner_SA_remote_simpL2_qp11_qt6_decompJPEG_1440x1440_Q10",0.841463414634148,53,29,50,28,160
"abel_highpoly_meshexp","abel_highpoly_meshexp_simpL2_qp9_qt6_decompJPEG_2048x2048_Q25",0.553571428571427,30,24,20,16,90
"abel_highpoly_meshexp","abel_highpoly_meshexp_simpL7_qp10_qt6_decompJPEG_2048x2048_Q75",0.378048780487805,30,24,20,16,90
"Beethoven_bakedUV2","Beethoven_bakedUV2_simpL10_qp11_qt6_decompJPEG_712x712_Q25",0.90909090909091,44,40,44,39,167
"Beethoven_bakedUV2","Beethoven_bakedUV2_simpL4_qp9_qt9_decompJPEG_512x512_Q50",0.474358974358975,44,40,44,39,167
"1970.16_Neck_Amphora_100K","1970.16_Neck_Amphora_100K_simpL10_qp10_qt7_decompJPEG_2048x2048_Q25",0.352272727272728,72,77,86,78,313
"Jomon_bakedUV","Jomon_bakedUV_simpL4_qp8_qt8_decompJPEG_712x712_Q90",0.540697674418605,71,73,86,70,300
"sylvaniapathmaker","sylvaniapathmaker_simpL3_qp11_qt10_decompJPEG_512x512_Q25",0.267441860465118,81,65,84,68,298
"to_subs","to_subs_simpL9_qp11_qt10_decompJPEG_512x512_Q90",0.303571428571427,15,0,22,0,37
"abel_highpoly_meshexp","abel_highpoly_meshexp_simpL10_qp7_qt7_decompJPEG_2048x2048_Q90",0.433333333333332,30,24,20,16,90
"CharlieChaplin","CharlieChaplin_simpL9_qp7_qt6_decompJPEG_712x712_Q75",0.958333333333332,37,32,42,19,130
"abel_highpoly_meshexp","abel_highpoly_meshexp_simpL2_qp10_qt6_decompJPEG_2048x2048_Q25",0.448863636363637,30,24,20,16,90
"to_subs","to_subs_simpL6_qp7_qt9_decompJPEG_712x712_Q10",0.957317073170733,15,0,22,0,37
"Beethoven_bakedUV2","Beethoven_bakedUV2_simpL10_qp10_qt6_decompJPEG_712x712_Q25",0.90340909090909,44,40,44,39,167
"Jomon_bakedUV","Jomon_bakedUV_simpL6_qp8_qt9_decompJPEG_2048x2048_Q10",0.54375,71,73,86,70,300
"sylvaniapathmaker","sylvaniapathmaker_simpL10_qp10_qt9_decompJPEG_2048x2048_Q10",0.54375,81,65,84,68,298
"to_subs","to_subs_simpL9_qp7_qt6_decompJPEG_712x712_Q10",0.948863636363638,15,0,22,0,37
"to_subs","to_subs_simpL9_qp7_qt6_decompJPEG_1440x1440_Q75",0.960227272727272,15,0,22,0,37
"1970.16_Neck_Amphora_100K","1970.16_Neck_Amphora_100K_simpL10_qp7_qt7_decompJPEG_2048x2048_Q10",0.386904761904763,72,77,86,78,313
"to_subs","to_subs_simpL9_qp10_qt9_decompJPEG_2048x2048_Q75",0.375,15,0,22,0,37
"abel_highpoly_meshexp","abel_highpoly_meshexp_simpL3_qp11_qt6_decompJPEG_1440x1440_Q50",0.431818181818183,30,24,20,16,90
"TimeWarner_SA_remote","TimeWarner_SA_remote_simpL1_qp10_qt6_decompJPEG_1440x1440_Q50",0.821428571428573,53,29,50,28,160
"dom_utka","dom_utka_simpL10_qp11_qt7_decompJPEG_1440x1440_Q90",0.5,45,31,45,27,148
"dom_utka","dom_utka_simpL1_qp8_qt10_decompJPEG_1024x1024_Q50",0.546511627906977,45,31,45,27,148
"Jomon_bakedUV","Jomon_bakedUV_simpL3_qp11_qt6_decompJPEG_2048x2048_Q90",0.65909090909091,71,73,86,70,300
"piano","piano_simpL1_qp10_qt7_decompJPEG_2048x2048_Q90",0.142045454545455,109,90,148,90,437
"to_subs","to_subs_simpL10_qp11_qt8_decompJPEG_2048x2048_Q90",0.994318181818183,15,0,22,0,37
"piano","piano_simpL4_qp9_qt7_decompJPEG_1024x1024_Q90",0.19047619047619,109,90,148,90,437
"Beethoven_bakedUV2","Beethoven_bakedUV2_simpL2_qp9_qt8_decompJPEG_712x712_Q75",0.546511627906977,44,40,44,39,167
"Ailurodus_maculosus","Ailurodus_maculosus_simpL10_qp11_qt10_decompJPEG_2048x2048_Q75",0.410714285714285,50,47,48,47,192
"piano","piano_simpL9_qp8_qt6_decompJPEG_1440x1440_Q75",0.482558139534882,109,90,148,90,437
"piano","piano_simpL2_qp9_qt7_decompJPEG_2048x2048_Q75",0.21951219512195,109,90,148,90,437
"abel_highpoly_meshexp","abel_highpoly_meshexp_simpL10_qp7_qt7_decompJPEG_1024x1024_Q25",0.5,30,24,20,16,90
"CharlieChaplin","CharlieChaplin_simpL1_qp7_qt6_decompJPEG_512x512_Q50",1,37,32,42,19,130
"piano","piano_simpL9_qp9_qt7_decompJPEG_512x512_Q25",0.363095238095237,109,90,148,90,437
"CharlieChaplin","CharlieChaplin_simpL10_qp11_qt6_decompJPEG_1024x1024_Q10",0.908536585365852,37,32,42,19,130
"to_subs","to_subs_simpL6_qp7_qt8_decompJPEG_512x512_Q25",0.928571428571427,15,0,22,0,37
"abel_highpoly_meshexp","abel_highpoly_meshexp_simpL4_qp8_qt10_decompJPEG_712x712_Q75",0.622222222222222,30,24,20,16,90
"sylvaniapathmaker","sylvaniapathmaker_simpL10_qp7_qt7_decompJPEG_1024x1024_Q25",0.72159090909091,81,65,84,68,298
"piano","piano_simpL8_qp10_qt7_decompJPEG_1024x1024_Q50",0.23170731707317,109,90,148,90,437
"to_subs","to_subs_simpL9_qp7_qt6_decompJPEG_512x512_Q10",0.94375,15,0,22,0,37
"to_subs","to_subs_simpL9_qp7_qt7_decompJPEG_1024x1024_Q75",0.960227272727272,15,0,22,0,37
"to_subs","to_subs_simpL1_qp8_qt7_decompJPEG_1440x1440_Q10",0.77840909090909,15,0,22,0,37
"Jomon_bakedUV","Jomon_bakedUV_simpL6_qp8_qt7_decompJPEG_2048x2048_Q75",0.604651162790698,71,73,86,70,300
"to_subs","to_subs_simpL6_qp7_qt10_decompJPEG_512x512_Q75",0.91860465116279,15,0,22,0,37
"Jomon_bakedUV","Jomon_bakedUV_simpL2_qp8_qt10_decompJPEG_1440x1440_Q25",0.56547619047619,71,73,86,70,300
"piano","piano_simpL2_qp11_qt7_decompJPEG_712x712_Q75",0.133720930232557,109,90,148,90,437
"dom_utka","dom_utka_simpL5_qp8_qt9_decompJPEG_512x512_Q25",0.459302325581395,45,31,45,27,148
"dom_utka","dom_utka_simpL10_qp8_qt8_decompJPEG_712x712_Q25",0.464285714285715,45,31,45,27,148
"abel_highpoly_meshexp","abel_highpoly_meshexp_simpL3_qp10_qt6_decompJPEG_512x512_Q25",0.410714285714285,30,24,20,16,90
"abel_highpoly_meshexp","abel_highpoly_meshexp_simpL9_qp9_qt6_decompJPEG_2048x2048_Q75",0.566666666666668,30,24,20,16,90
"Beethoven_bakedUV2","Beethoven_bakedUV2_simpL6_qp9_qt6_decompJPEG_2048x2048_Q90",0.801136363636362,44,40,44,39,167
"piano","piano_simpL1_qp9_qt7_decompJPEG_2048x2048_Q90",0.2375,109,90,148,90,437
"sylvaniapathmaker","sylvaniapathmaker_simpL10_qp10_qt10_decompJPEG_2048x2048_Q75",0.529761904761905,81,65,84,68,298
"dom_utka","dom_utka_simpL2_qp11_qt7_decompJPEG_512x512_Q25",0.523255813953488,45,31,45,27,148
"Jomon_bakedUV","Jomon_bakedUV_simpL3_qp10_qt7_decompJPEG_512x512_Q10",0.453488372093023,71,73,86,70,300
"abel_highpoly_meshexp","abel_highpoly_meshexp_simpL8_qp8_qt10_decompJPEG_2048x2048_Q10",0.595238095238095,30,24,20,16,90
"piano","piano_simpL2_qp10_qt7_decompJPEG_712x712_Q90",0.13953488372093,109,90,148,90,437
"sylvaniapathmaker","sylvaniapathmaker_simpL9_qp9_qt8_decompJPEG_1440x1440_Q25",0.511904761904763,81,65,84,68,298
"1970.16_Neck_Amphora_100K","1970.16_Neck_Amphora_100K_simpL10_qp8_qt7_decompJPEG_1440x1440_Q25",0.428571428571427,72,77,86,78,313
"CharlieChaplin","CharlieChaplin_simpL10_qp8_qt6_decompJPEG_712x712_Q10",0.944444444444445,37,32,42,19,130
"1970.16_Neck_Amphora_100K","1970.16_Neck_Amphora_100K_simpL3_qp11_qt10_decompJPEG_512x512_Q50",0.186046511627908,72,77,86,78,313
"to_subs","to_subs_simpL9_qp10_qt10_decompJPEG_712x712_Q90",0.297619047619047,15,0,22,0,37
"sylvaniapathmaker","sylvaniapathmaker_simpL9_qp8_qt8_decompJPEG_1440x1440_Q25",0.52906976744186,81,65,84,68,298
"CharlieChaplin","CharlieChaplin_simpL1_qp7_qt6_decompJPEG_512x512_Q10",0.98780487804878,37,32,42,19,130
"sylvaniapathmaker","sylvaniapathmaker_simpL10_qp8_qt7_decompJPEG_2048x2048_Q25",0.664634146341462,81,65,84,68,298
"to_subs","to_subs_simpL7_qp8_qt6_decompJPEG_1440x1440_Q10",0.813953488372092,15,0,22,0,37
"1970.16_Neck_Amphora_100K","1970.16_Neck_Amphora_100K_simpL3_qp9_qt10_decompJPEG_512x512_Q25",0.322222222222223,72,77,86,78,313
"Jomon_bakedUV","Jomon_bakedUV_simpL7_qp8_qt10_decompJPEG_2048x2048_Q10",0.505813953488373,71,73,86,70,300
"abel_highpoly_meshexp","abel_highpoly_meshexp_simpL3_qp8_qt10_decompJPEG_1024x1024_Q50",0.627906976744185,30,24,20,16,90
"1970.16_Neck_Amphora_100K","1970.16_Neck_Amphora_100K_simpL9_qp9_qt8_decompJPEG_1440x1440_Q25",0.166666666666667,72,77,86,78,313
"dom_utka","dom_utka_simpL1_qp10_qt7_decompJPEG_1024x1024_Q25",0.47159090909091,45,31,45,27,148
"TimeWarner_SA_remote","TimeWarner_SA_remote_simpL9_qp11_qt6_decompJPEG_2048x2048_Q90",0.822222222222223,53,29,50,28,160
"Beethoven_bakedUV2","Beethoven_bakedUV2_simpL4_qp8_qt8_decompJPEG_1024x1024_Q25",0.78888888888889,44,40,44,39,167
"sylvaniapathmaker","sylvaniapathmaker_simpL1_qp9_qt8_decompJPEG_512x512_Q25",0.470238095238095,81,65,84,68,298
"TimeWarner_SA_remote","TimeWarner_SA_remote_simpL10_qp10_qt6_decompJPEG_1440x1440_Q75",0.74390243902439,53,29,50,28,160
"Ailurodus_maculosus","Ailurodus_maculosus_simpL10_qp11_qt7_decompJPEG_2048x2048_Q75",0.5,50,47,48,47,192
"dom_utka","dom_utka_simpL10_qp7_qt7_decompJPEG_1024x1024_Q75",0.587209302325583,45,31,45,27,148
"abel_highpoly_meshexp","abel_highpoly_meshexp_simpL9_qp10_qt6_decompJPEG_2048x2048_Q25",0.463414634146343,30,24,20,16,90
"1970.16_Neck_Amphora_100K","1970.16_Neck_Amphora_100K_simpL10_qp9_qt7_decompJPEG_2048x2048_Q90",0.384146341463415,72,77,86,78,313
"1970.16_Neck_Amphora_100K","1970.16_Neck_Amphora_100K_simpL10_qp11_qt6_decompJPEG_1024x1024_Q25",0.43125,72,77,86,78,313
"piano","piano_simpL9_qp11_qt6_decompJPEG_2048x2048_Q25",0.519736842105262,109,90,148,90,437
"Ailurodus_maculosus","Ailurodus_maculosus_simpL10_qp9_qt6_decompJPEG_1024x1024_Q50",0.58139534883721,50,47,48,47,192
"Jomon_bakedUV","Jomon_bakedUV_simpL1_qp9_qt6_decompJPEG_712x712_Q25",0.645348837209302,71,73,86,70,300
"piano","piano_simpL6_qp9_qt7_decompJPEG_2048x2048_Q75",0.170454545454545,109,90,148,90,437
"Ailurodus_maculosus","Ailurodus_maculosus_simpL7_qp9_qt10_decompJPEG_712x712_Q90",0.160714285714285,50,47,48,47,192
"piano","piano_simpL9_qp9_qt6_decompJPEG_1024x1024_Q90",0.452380952380953,109,90,148,90,437
"dom_utka","dom_utka_simpL1_qp11_qt8_decompJPEG_1024x1024_Q10",0.220238095238095,45,31,45,27,148
"Beethoven_bakedUV2","Beethoven_bakedUV2_simpL10_qp7_qt6_decompJPEG_2048x2048_Q50",0.906976744186047,44,40,44,39,167
"to_subs","to_subs_simpL3_qp10_qt7_decompJPEG_1440x1440_Q50",0.25595238095238,15,0,22,0,37
"Beethoven_bakedUV2","Beethoven_bakedUV2_simpL10_qp8_qt6_decompJPEG_712x712_Q10",0.90625,44,40,44,39,167
"1970.16_Neck_Amphora_100K","1970.16_Neck_Amphora_100K_simpL10_qp10_qt7_decompJPEG_1024x1024_Q25",0.355555555555555,72,77,86,78,313
"Jomon_bakedUV","Jomon_bakedUV_simpL7_qp8_qt10_decompJPEG_1440x1440_Q10",0.540697674418605,71,73,86,70,300
"1970.16_Neck_Amphora_100K","1970.16_Neck_Amphora_100K_simpL1_qp11_qt10_decompJPEG_512x512_Q25",0.238372093023255,72,77,86,78,313
"Beethoven_bakedUV2","Beethoven_bakedUV2_simpL10_qp8_qt6_decompJPEG_712x712_Q25",0.884146341463415,44,40,44,39,167
"abel_highpoly_meshexp","abel_highpoly_meshexp_simpL3_qp9_qt6_decompJPEG_712x712_Q50",0.475,30,24,20,16,90
"Ailurodus_maculosus","Ailurodus_maculosus_simpL10_qp11_qt10_decompJPEG_2048x2048_Q90",0.426136363636363,50,47,48,47,192
"CharlieChaplin","CharlieChaplin_simpL10_qp11_qt7_decompJPEG_2048x2048_Q90",0.9,37,32,42,19,130
"abel_highpoly_meshexp","abel_highpoly_meshexp_simpL9_qp10_qt6_decompJPEG_712x712_Q25",0.43125,30,24,20,16,90
"CharlieChaplin","CharlieChaplin_simpL10_qp11_qt6_decompJPEG_1440x1440_Q90",0.94186046511628,37,32,42,19,130
"Ailurodus_maculosus","Ailurodus_maculosus_simpL6_qp9_qt10_decompJPEG_1024x1024_Q90",0.296511627906977,50,47,48,47,192
"CharlieChaplin","CharlieChaplin_simpL1_qp11_qt6_decompJPEG_1024x1024_Q25",0.61875,37,32,42,19,130
"1970.16_Neck_Amphora_100K","1970.16_Neck_Amphora_100K_simpL10_qp10_qt7_decompJPEG_2048x2048_Q50",0.396341463414635,72,77,86,78,313
"Jomon_bakedUV","Jomon_bakedUV_simpL9_qp10_qt7_decompJPEG_712x712_Q90",0.482558139534882,71,73,86,70,300
"Jomon_bakedUV","Jomon_bakedUV_simpL2_qp9_qt7_decompJPEG_1440x1440_Q90",0.398809523809525,71,73,86,70,300
"piano","piano_simpL1_qp9_qt7_decompJPEG_2048x2048_Q75",0.26829268292683,109,90,148,90,437
"1970.16_Neck_Amphora_100K","1970.16_Neck_Amphora_100K_simpL10_qp9_qt7_decompJPEG_1024x1024_Q90",0.318181818181817,72,77,86,78,313
"Beethoven_bakedUV2","Beethoven_bakedUV2_simpL7_qp8_qt8_decompJPEG_512x512_Q90",0.77906976744186,44,40,44,39,167
"1970.16_Neck_Amphora_100K","1970.16_Neck_Amphora_100K_simpL10_qp10_qt10_decompJPEG_2048x2048_Q75",0.352272727272728,72,77,86,78,313
"Jomon_bakedUV","Jomon_bakedUV_simpL2_qp8_qt9_decompJPEG_512x512_Q90",0.540697674418605,71,73,86,70,300
"sylvaniapathmaker","sylvaniapathmaker_simpL1_qp8_qt9_decompJPEG_2048x2048_Q75",0.571428571428573,81,65,84,68,298
"piano","piano_simpL1_qp10_qt7_decompJPEG_1024x1024_Q75",0.175,109,90,148,90,437
"TimeWarner_SA_remote","TimeWarner_SA_remote_simpL4_qp11_qt6_decompJPEG_712x712_Q90",0.814102564102565,53,29,50,28,160
"to_subs","to_subs_simpL10_qp11_qt8_decompJPEG_1024x1024_Q90",0.965116279069767,15,0,22,0,37
"abel_highpoly_meshexp","abel_highpoly_meshexp_simpL9_qp10_qt6_decompJPEG_1024x1024_Q25",0.345238095238095,30,24,20,16,90
"1970.16_Neck_Amphora_100K","1970.16_Neck_Amphora_100K_simpL10_qp10_qt7_decompJPEG_2048x2048_Q75",0.395348837209302,72,77,86,78,313
"Beethoven_bakedUV2","Beethoven_bakedUV2_simpL8_qp8_qt6_decompJPEG_2048x2048_Q50",0.90340909090909,44,40,44,39,167
"piano","piano_simpL9_qp10_qt7_decompJPEG_1440x1440_Q50",0.33125,109,90,148,90,437
"dom_utka","dom_utka_simpL1_qp11_qt8_decompJPEG_712x712_Q10",0.25595238095238,45,31,45,27,148
"TimeWarner_SA_remote","TimeWarner_SA_remote_simpL8_qp8_qt9_decompJPEG_512x512_Q75",0.790697674418605,53,29,50,28,160
"Beethoven_bakedUV2","Beethoven_bakedUV2_simpL9_qp10_qt6_decompJPEG_1440x1440_Q25",0.738372093023255,44,40,44,39,167
"CharlieChaplin","CharlieChaplin_simpL10_qp11_qt7_decompJPEG_1024x1024_Q90",0.90340909090909,37,32,42,19,130
"sylvaniapathmaker","sylvaniapathmaker_simpL2_qp9_qt8_decompJPEG_512x512_Q25",0.43452380952381,81,65,84,68,298
"Beethoven_bakedUV2","Beethoven_bakedUV2_simpL2_qp8_qt8_decompJPEG_1024x1024_Q25",0.839285714285715,44,40,44,39,167
"TimeWarner_SA_remote","TimeWarner_SA_remote_simpL7_qp11_qt6_decompJPEG_712x712_Q75",0.804878048780488,53,29,50,28,160
"piano","piano_simpL6_qp10_qt7_decompJPEG_2048x2048_Q25",0.15340909090909,109,90,148,90,437
"1970.16_Neck_Amphora_100K","1970.16_Neck_Amphora_100K_simpL6_qp11_qt9_decompJPEG_512x512_Q25",0.383720930232557,72,77,86,78,313
"Ailurodus_maculosus","Ailurodus_maculosus_simpL9_qp11_qt7_decompJPEG_1024x1024_Q25",0.420454545454545,50,47,48,47,192
"Ailurodus_maculosus","Ailurodus_maculosus_simpL10_qp9_qt7_decompJPEG_1440x1440_Q75",0.517045454545455,50,47,48,47,192
"piano","piano_simpL8_qp10_qt7_decompJPEG_2048x2048_Q25",0.22093023255814,109,90,148,90,437
"Beethoven_bakedUV2","Beethoven_bakedUV2_simpL2_qp9_qt9_decompJPEG_512x512_Q75",0.52906976744186,44,40,44,39,167
"Beethoven_bakedUV2","Beethoven_bakedUV2_simpL10_qp11_qt6_decompJPEG_512x512_Q10",0.892857142857143,44,40,44,39,167
"CharlieChaplin","CharlieChaplin_simpL1_qp7_qt6_decompJPEG_712x712_Q25",1,37,32,42,19,130
"Ailurodus_maculosus","Ailurodus_maculosus_simpL10_qp11_qt6_decompJPEG_2048x2048_Q75",0.589285714285715,50,47,48,47,192
"Jomon_bakedUV","Jomon_bakedUV_simpL2_qp9_qt6_decompJPEG_1024x1024_Q10",0.708333333333332,71,73,86,70,300
"dom_utka","dom_utka_simpL1_qp11_qt8_decompJPEG_2048x2048_Q10",0.24375,45,31,45,27,148
"dom_utka","dom_utka_simpL9_qp7_qt10_decompJPEG_512x512_Q10",0.652439024390245,45,31,45,27,148
"TimeWarner_SA_remote","TimeWarner_SA_remote_simpL4_qp11_qt6_decompJPEG_712x712_Q25",0.886363636363638,53,29,50,28,160
"TimeWarner_SA_remote","TimeWarner_SA_remote_simpL6_qp11_qt6_decompJPEG_712x712_Q90",0.871951219512195,53,29,50,28,160
"abel_highpoly_meshexp","abel_highpoly_meshexp_simpL10_qp8_qt7_decompJPEG_1024x1024_Q75",0.351190476190475,30,24,20,16,90
"Ailurodus_maculosus","Ailurodus_maculosus_simpL10_qp10_qt10_decompJPEG_1024x1024_Q50",0.43452380952381,50,47,48,47,192
"to_subs","to_subs_simpL2_qp11_qt7_decompJPEG_2048x2048_Q90",0.19186046511628,15,0,22,0,37
"CharlieChaplin","CharlieChaplin_simpL10_qp10_qt6_decompJPEG_512x512_Q25",0.925,37,32,42,19,130
"sylvaniapathmaker","sylvaniapathmaker_simpL8_qp7_qt8_decompJPEG_1024x1024_Q25",0.790697674418605,81,65,84,68,298
"Ailurodus_maculosus","Ailurodus_maculosus_simpL8_qp8_qt9_decompJPEG_1440x1440_Q10",0.539772727272728,50,47,48,47,192
"sylvaniapathmaker","sylvaniapathmaker_simpL8_qp9_qt8_decompJPEG_512x512_Q75",0.448863636363637,81,65,84,68,298
"dom_utka","dom_utka_simpL10_qp7_qt6_decompJPEG_2048x2048_Q75",0.676829268292683,45,31,45,27,148
"dom_utka","dom_utka_simpL9_qp9_qt7_decompJPEG_712x712_Q75",0.227777777777777,45,31,45,27,148
"Beethoven_bakedUV2","Beethoven_bakedUV2_simpL10_qp10_qt6_decompJPEG_1024x1024_Q90",0.922619047619047,44,40,44,39,167
"1970.16_Neck_Amphora_100K","1970.16_Neck_Amphora_100K_simpL10_qp10_qt9_decompJPEG_1024x1024_Q50",0.306818181818183,72,77,86,78,313
"sylvaniapathmaker","sylvaniapathmaker_simpL7_qp8_qt10_decompJPEG_512x512_Q10",0.616279069767443,81,65,84,68,298
"TimeWarner_SA_remote","TimeWarner_SA_remote_simpL9_qp11_qt6_decompJPEG_1440x1440_Q90",0.823863636363638,53,29,50,28,160
"to_subs","to_subs_simpL9_qp7_qt6_decompJPEG_512x512_Q25",0.90909090909091,15,0,22,0,37
"Ailurodus_maculosus","Ailurodus_maculosus_simpL6_qp9_qt10_decompJPEG_2048x2048_Q50",0.232558139534883,50,47,48,47,192
"to_subs","to_subs_simpL3_qp8_qt6_decompJPEG_1440x1440_Q10",0.795454545454545,15,0,22,0,37
"Ailurodus_maculosus","Ailurodus_maculosus_simpL9_qp11_qt8_decompJPEG_1024x1024_Q75",0.208333333333333,50,47,48,47,192
"sylvaniapathmaker","sylvaniapathmaker_simpL1_qp8_qt9_decompJPEG_1024x1024_Q75",0.58139534883721,81,65,84,68,298
"CharlieChaplin","CharlieChaplin_simpL8_qp10_qt6_decompJPEG_512x512_Q25",0.732142857142858,37,32,42,19,130
"to_subs","to_subs_simpL9_qp8_qt7_decompJPEG_512x512_Q75",0.692307692307693,15,0,22,0,37
"to_subs","to_subs_simpL6_qp7_qt10_decompJPEG_1024x1024_Q75",0.928571428571427,15,0,22,0,37
"to_subs","to_subs_simpL9_qp8_qt6_decompJPEG_712x712_Q90",0.676136363636363,15,0,22,0,37
"TimeWarner_SA_remote","TimeWarner_SA_remote_simpL3_qp9_qt10_decompJPEG_712x712_Q10",0.732954545454545,53,29,50,28,160
"Ailurodus_maculosus","Ailurodus_maculosus_simpL10_qp10_qt8_decompJPEG_2048x2048_Q75",0.38953488372093,50,47,48,47,192
"TimeWarner_SA_remote","TimeWarner_SA_remote_simpL7_qp10_qt9_decompJPEG_512x512_Q25",0.47159090909091,53,29,50,28,160
"piano","piano_simpL9_qp9_qt7_decompJPEG_2048x2048_Q50",0.357142857142858,109,90,148,90,437
"Beethoven_bakedUV2","Beethoven_bakedUV2_simpL10_qp10_qt6_decompJPEG_1024x1024_Q50",0.901162790697675,44,40,44,39,167
"Ailurodus_maculosus","Ailurodus_maculosus_simpL1_qp11_qt6_decompJPEG_512x512_Q25",0.74375,50,47,48,47,192
"sylvaniapathmaker","sylvaniapathmaker_simpL10_qp10_qt7_decompJPEG_2048x2048_Q50",0.656976744186047,81,65,84,68,298
"Beethoven_bakedUV2","Beethoven_bakedUV2_simpL7_qp11_qt6_decompJPEG_2048x2048_Q50",0.772727272727272,44,40,44,39,167
"Ailurodus_maculosus","Ailurodus_maculosus_simpL6_qp9_qt9_decompJPEG_512x512_Q75",0.322222222222223,50,47,48,47,192
"CharlieChaplin","CharlieChaplin_simpL10_qp11_qt6_decompJPEG_1440x1440_Q50",0.914772727272728,37,32,42,19,130
"abel_highpoly_meshexp","abel_highpoly_meshexp_simpL9_qp10_qt6_decompJPEG_712x712_Q50",0.446428571428573,30,24,20,16,90
"Beethoven_bakedUV2","Beethoven_bakedUV2_simpL8_qp9_qt8_decompJPEG_712x712_Q50",0.460227272727272,44,40,44,39,167
"dom_utka","dom_utka_simpL10_qp7_qt8_decompJPEG_1024x1024_Q75",0.619318181818183,45,31,45,27,148
"Beethoven_bakedUV2","Beethoven_bakedUV2_simpL4_qp9_qt6_decompJPEG_1024x1024_Q75",0.704545454545455,44,40,44,39,167
"TimeWarner_SA_remote","TimeWarner_SA_remote_simpL4_qp11_qt7_decompJPEG_1440x1440_Q75",0.640243902439025,53,29,50,28,160
"sylvaniapathmaker","sylvaniapathmaker_simpL10_qp11_qt8_decompJPEG_2048x2048_Q10",0.575581395348837,81,65,84,68,298
"CharlieChaplin","CharlieChaplin_simpL9_qp11_qt8_decompJPEG_1440x1440_Q90",0.47159090909091,37,32,42,19,130
"1970.16_Neck_Amphora_100K","1970.16_Neck_Amphora_100K_simpL5_qp9_qt10_decompJPEG_512x512_Q50",0.210227272727272,72,77,86,78,313
"Jomon_bakedUV","Jomon_bakedUV_simpL5_qp10_qt6_decompJPEG_2048x2048_Q50",0.69767441860465,71,73,86,70,300
"piano","piano_simpL9_qp11_qt7_decompJPEG_1440x1440_Q25",0.325,109,90,148,90,437
"Jomon_bakedUV","Jomon_bakedUV_simpL8_qp8_qt10_decompJPEG_1440x1440_Q10",0.625,71,73,86,70,300
"dom_utka","dom_utka_simpL10_qp7_qt6_decompJPEG_1440x1440_Q75",0.678571428571427,45,31,45,27,148
"to_subs","to_subs_simpL10_qp7_qt9_decompJPEG_512x512_Q10",1,15,0,22,0,37
"Beethoven_bakedUV2","Beethoven_bakedUV2_simpL10_qp9_qt6_decompJPEG_712x712_Q10",0.896341463414635,44,40,44,39,167
"sylvaniapathmaker","sylvaniapathmaker_simpL10_qp10_qt7_decompJPEG_2048x2048_Q90",0.65340909090909,81,65,84,68,298
"Jomon_bakedUV","Jomon_bakedUV_simpL1_qp11_qt7_decompJPEG_1440x1440_Q75",0.392045454545455,71,73,86,70,300
"CharlieChaplin","CharlieChaplin_simpL10_qp11_qt10_decompJPEG_1440x1440_Q90",0.88095238095238,37,32,42,19,130
"Ailurodus_maculosus","Ailurodus_maculosus_simpL6_qp9_qt7_decompJPEG_1440x1440_Q75",0.47560975609756,50,47,48,47,192
"CharlieChaplin","CharlieChaplin_simpL9_qp9_qt6_decompJPEG_712x712_Q50",0.833333333333332,37,32,42,19,130
"Jomon_bakedUV","Jomon_bakedUV_simpL8_qp11_qt7_decompJPEG_512x512_Q10",0.592105263157895,71,73,86,70,300
"dom_utka","dom_utka_simpL8_qp7_qt8_decompJPEG_1440x1440_Q75",0.77906976744186,45,31,45,27,148
"Beethoven_bakedUV2","Beethoven_bakedUV2_simpL10_qp10_qt9_decompJPEG_512x512_Q10",0.857954545454545,44,40,44,39,167
"1970.16_Neck_Amphora_100K","1970.16_Neck_Amphora_100K_simpL10_qp11_qt7_decompJPEG_1024x1024_Q75",0.34090909090909,72,77,86,78,313
"TimeWarner_SA_remote","TimeWarner_SA_remote_simpL10_qp11_qt6_decompJPEG_1440x1440_Q90",0.73780487804878,53,29,50,28,160
"Jomon_bakedUV","Jomon_bakedUV_simpL1_qp11_qt6_decompJPEG_1440x1440_Q90",0.709302325581395,71,73,86,70,300
"Ailurodus_maculosus","Ailurodus_maculosus_simpL4_qp10_qt7_decompJPEG_1440x1440_Q10",0.488372093023255,50,47,48,47,192
"dom_utka","dom_utka_simpL9_qp11_qt7_decompJPEG_712x712_Q75",0.180232558139535,45,31,45,27,148
"Jomon_bakedUV","Jomon_bakedUV_simpL6_qp11_qt7_decompJPEG_1440x1440_Q25",0.3125,71,73,86,70,300
"1970.16_Neck_Amphora_100K","1970.16_Neck_Amphora_100K_simpL9_qp10_qt7_decompJPEG_1024x1024_Q75",0.306818181818183,72,77,86,78,313
"abel_highpoly_meshexp","abel_highpoly_meshexp_simpL3_qp11_qt6_decompJPEG_512x512_Q90",0.383720930232557,30,24,20,16,90
"abel_highpoly_meshexp","abel_highpoly_meshexp_simpL6_qp11_qt6_decompJPEG_1440x1440_Q50",0.353658536585365,30,24,20,16,90
"abel_highpoly_meshexp","abel_highpoly_meshexp_simpL1_qp8_qt8_decompJPEG_712x712_Q50",0.651162790697675,30,24,20,16,90
"TimeWarner_SA_remote","TimeWarner_SA_remote_simpL8_qp11_qt6_decompJPEG_1024x1024_Q50",0.845238095238095,53,29,50,28,160
"1970.16_Neck_Amphora_100K","1970.16_Neck_Amphora_100K_simpL5_qp11_qt10_decompJPEG_512x512_Q50",0.180232558139535,72,77,86,78,313
"TimeWarner_SA_remote","TimeWarner_SA_remote_simpL9_qp10_qt10_decompJPEG_512x512_Q25",0.44047619047619,53,29,50,28,160
"Ailurodus_maculosus","Ailurodus_maculosus_simpL10_qp10_qt9_decompJPEG_2048x2048_Q75",0.416666666666668,50,47,48,47,192
"Jomon_bakedUV","Jomon_bakedUV_simpL4_qp11_qt6_decompJPEG_2048x2048_Q90",0.645348837209302,71,73,86,70,300
"CharlieChaplin","CharlieChaplin_simpL9_qp10_qt6_decompJPEG_2048x2048_Q25",0.715116279069767,37,32,42,19,130
"1970.16_Neck_Amphora_100K","1970.16_Neck_Amphora_100K_simpL10_qp10_qt7_decompJPEG_1024x1024_Q90",0.377906976744185,72,77,86,78,313
"sylvaniapathmaker","sylvaniapathmaker_simpL8_qp8_qt8_decompJPEG_2048x2048_Q50",0.627777777777778,81,65,84,68,298
"TimeWarner_SA_remote","TimeWarner_SA_remote_simpL9_qp8_qt9_decompJPEG_512x512_Q50",0.685897435897435,53,29,50,28,160
"Ailurodus_maculosus","Ailurodus_maculosus_simpL8_qp8_qt8_decompJPEG_1024x1024_Q10",0.642045454545455,50,47,48,47,192
"TimeWarner_SA_remote","TimeWarner_SA_remote_simpL9_qp11_qt10_decompJPEG_712x712_Q10",0.572222222222223,53,29,50,28,160
"1970.16_Neck_Amphora_100K","1970.16_Neck_Amphora_100K_simpL4_qp8_qt9_decompJPEG_512x512_Q50",0.422619047619047,72,77,86,78,313
"dom_utka","dom_utka_simpL1_qp11_qt8_decompJPEG_512x512_Q75",0.166666666666667,45,31,45,27,148
"Ailurodus_maculosus","Ailurodus_maculosus_simpL10_qp11_qt6_decompJPEG_2048x2048_Q90",0.534883720930233,50,47,48,47,192
"sylvaniapathmaker","sylvaniapathmaker_simpL10_qp7_qt7_decompJPEG_2048x2048_Q75",0.69186046511628,81,65,84,68,298
"CharlieChaplin","CharlieChaplin_simpL1_qp7_qt6_decompJPEG_2048x2048_Q25",0.98780487804878,37,32,42,19,130
"dom_utka","dom_utka_simpL10_qp10_qt6_decompJPEG_1024x1024_Q50",0.607954545454545,45,31,45,27,148
"1970.16_Neck_Amphora_100K","1970.16_Neck_Amphora_100K_simpL9_qp9_qt8_decompJPEG_1440x1440_Q90",0.25,72,77,86,78,313
"Beethoven_bakedUV2","Beethoven_bakedUV2_simpL10_qp10_qt6_decompJPEG_512x512_Q10",0.91860465116279,44,40,44,39,167
"dom_utka","dom_utka_simpL10_qp7_qt7_decompJPEG_1024x1024_Q90",0.59659090909091,45,31,45,27,148
"Jomon_bakedUV","Jomon_bakedUV_simpL5_qp9_qt6_decompJPEG_2048x2048_Q75",0.714285714285715,71,73,86,70,300
"abel_highpoly_meshexp","abel_highpoly_meshexp_simpL3_qp10_qt6_decompJPEG_2048x2048_Q25",0.44767441860465,30,24,20,16,90
"TimeWarner_SA_remote","TimeWarner_SA_remote_simpL7_qp11_qt6_decompJPEG_712x712_Q50",0.818181818181817,53,29,50,28,160
"Beethoven_bakedUV2","Beethoven_bakedUV2_simpL10_qp8_qt6_decompJPEG_512x512_Q10",0.875,44,40,44,39,167
"piano","piano_simpL2_qp10_qt7_decompJPEG_1024x1024_Q75",0.213414634146343,109,90,148,90,437
"dom_utka","dom_utka_simpL10_qp7_qt6_decompJPEG_1024x1024_Q10",0.69767441860465,45,31,45,27,148
"Jomon_bakedUV","Jomon_bakedUV_simpL6_qp7_qt6_decompJPEG_1440x1440_Q90",0.964285714285715,71,73,86,70,300
"Jomon_bakedUV","Jomon_bakedUV_simpL3_qp11_qt6_decompJPEG_1024x1024_Q90",0.671052631578947,71,73,86,70,300
"to_subs","to_subs_simpL8_qp7_qt9_decompJPEG_512x512_Q10",0.952380952380953,15,0,22,0,37
"1970.16_Neck_Amphora_100K","1970.16_Neck_Amphora_100K_simpL9_qp11_qt7_decompJPEG_2048x2048_Q90",0.38953488372093,72,77,86,78,313
"Beethoven_bakedUV2","Beethoven_bakedUV2_simpL4_qp9_qt9_decompJPEG_512x512_Q75",0.52906976744186,44,40,44,39,167
"Beethoven_bakedUV2","Beethoven_bakedUV2_simpL10_qp8_qt6_decompJPEG_512x512_Q50",0.872222222222222,44,40,44,39,167
"Beethoven_bakedUV2","Beethoven_bakedUV2_simpL10_qp10_qt6_decompJPEG_712x712_Q10",0.905555555555555,44,40,44,39,167
"Beethoven_bakedUV2","Beethoven_bakedUV2_simpL6_qp8_qt8_decompJPEG_1024x1024_Q50",0.851190476190475,44,40,44,39,167
"to_subs","to_subs_simpL8_qp7_qt9_decompJPEG_712x712_Q10",0.94186046511628,15,0,22,0,37
"to_subs","to_subs_simpL10_qp10_qt7_decompJPEG_1024x1024_Q50",0.959302325581395,15,0,22,0,37
"piano","piano_simpL1_qp11_qt7_decompJPEG_2048x2048_Q25",0.225,109,90,148,90,437
"piano","piano_simpL9_qp9_qt6_decompJPEG_2048x2048_Q90",0.390243902439025,109,90,148,90,437
"piano","piano_simpL9_qp9_qt6_decompJPEG_1440x1440_Q25",0.416666666666668,109,90,148,90,437
"TimeWarner_SA_remote","TimeWarner_SA_remote_simpL5_qp11_qt6_decompJPEG_1440x1440_Q75",0.829545454545455,53,29,50,28,160
"dom_utka","dom_utka_simpL1_qp9_qt8_decompJPEG_1440x1440_Q10",0.289772727272728,45,31,45,27,148
"1970.16_Neck_Amphora_100K","1970.16_Neck_Amphora_100K_simpL10_qp9_qt6_decompJPEG_1440x1440_Q90",0.49404761904762,72,77,86,78,313
"abel_highpoly_meshexp","abel_highpoly_meshexp_simpL10_qp7_qt6_decompJPEG_712x712_Q10",0.536585365853657,30,24,20,16,90
"sylvaniapathmaker","sylvaniapathmaker_simpL10_qp8_qt9_decompJPEG_1024x1024_Q10",0.648809523809525,81,65,84,68,298
"1970.16_Neck_Amphora_100K","1970.16_Neck_Amphora_100K_simpL6_qp9_qt9_decompJPEG_512x512_Q50",0.279761904761905,72,77,86,78,313
"Jomon_bakedUV","Jomon_bakedUV_simpL4_qp10_qt6_decompJPEG_2048x2048_Q75",0.602564102564103,71,73,86,70,300
"abel_highpoly_meshexp","abel_highpoly_meshexp_simpL10_qp7_qt7_decompJPEG_1440x1440_Q10",0.50609756097561,30,24,20,16,90
"Ailurodus_maculosus","Ailurodus_maculosus_simpL5_qp9_qt10_decompJPEG_712x712_Q25",0.30952380952381,50,47,48,47,192
"Beethoven_bakedUV2","Beethoven_bakedUV2_simpL1_qp9_qt10_decompJPEG_2048x2048_Q90",0.525,44,40,44,39,167
"1970.16_Neck_Amphora_100K","1970.16_Neck_Amphora_100K_simpL9_qp9_qt8_decompJPEG_1024x1024_Q50",0.255681818181817,72,77,86,78,313
"Jomon_bakedUV","Jomon_bakedUV_simpL1_qp11_qt7_decompJPEG_512x512_Q10",0.45,71,73,86,70,300
"Beethoven_bakedUV2","Beethoven_bakedUV2_simpL1_qp9_qt10_decompJPEG_512x512_Q75",0.535714285714285,44,40,44,39,167
"CharlieChaplin","CharlieChaplin_simpL10_qp11_qt8_decompJPEG_2048x2048_Q10",0.86904761904762,37,32,42,19,130
"piano","piano_simpL4_qp11_qt7_decompJPEG_2048x2048_Q90",0.147727272727272,109,90,148,90,437
"CharlieChaplin","CharlieChaplin_simpL10_qp9_qt8_decompJPEG_1024x1024_Q50",0.931818181818183,37,32,42,19,130
"to_subs","to_subs_simpL4_qp9_qt6_decompJPEG_1024x1024_Q75",0.337209302325583,15,0,22,0,37
"1970.16_Neck_Amphora_100K","1970.16_Neck_Amphora_100K_simpL10_qp8_qt7_decompJPEG_1024x1024_Q50",0.348837209302325,72,77,86,78,313
"sylvaniapathmaker","sylvaniapathmaker_simpL1_qp8_qt10_decompJPEG_512x512_Q50",0.587209302325583,81,65,84,68,298
"TimeWarner_SA_remote","TimeWarner_SA_remote_simpL6_qp11_qt6_decompJPEG_512x512_Q25",0.886904761904763,53,29,50,28,160
"Ailurodus_maculosus","Ailurodus_maculosus_simpL7_qp9_qt9_decompJPEG_512x512_Q75",0.27906976744186,50,47,48,47,192
"piano","piano_simpL9_qp9_qt6_decompJPEG_712x712_Q90",0.494444444444445,109,90,148,90,437
"CharlieChaplin","CharlieChaplin_simpL10_qp7_qt6_decompJPEG_512x512_Q10",0.96590909090909,37,32,42,19,130
"piano","piano_simpL4_qp11_qt7_decompJPEG_1440x1440_Q25",0.151162790697675,109,90,148,90,437
"Jomon_bakedUV","Jomon_bakedUV_simpL4_qp11_qt6_decompJPEG_712x712_Q25",0.522727272727272,71,73,86,70,300
"Jomon_bakedUV","Jomon_bakedUV_simpL9_qp9_qt6_decompJPEG_1440x1440_Q75",0.896341463414635,71,73,86,70,300
"1970.16_Neck_Amphora_100K","1970.16_Neck_Amphora_100K_simpL9_qp9_qt7_decompJPEG_2048x2048_Q25",0.31111111111111,72,77,86,78,313
"Beethoven_bakedUV2","Beethoven_bakedUV2_simpL5_qp11_qt6_decompJPEG_2048x2048_Q10",0.68452380952381,44,40,44,39,167
"Ailurodus_maculosus","Ailurodus_maculosus_simpL10_qp10_qt10_decompJPEG_2048x2048_Q75",0.48170731707317,50,47,48,47,192
"1970.16_Neck_Amphora_100K","1970.16_Neck_Amphora_100K_simpL10_qp9_qt9_decompJPEG_1440x1440_Q50",0.333333333333332,72,77,86,78,313
"1970.16_Neck_Amphora_100K","1970.16_Neck_Amphora_100K_simpL9_qp9_qt8_decompJPEG_2048x2048_Q75",0.284883720930233,72,77,86,78,313
"Jomon_bakedUV","Jomon_bakedUV_simpL10_qp7_qt8_decompJPEG_512x512_Q10",0.97159090909091,71,73,86,70,300
"dom_utka","dom_utka_simpL10_qp7_qt6_decompJPEG_2048x2048_Q10",0.633720930232557,45,31,45,27,148
"sylvaniapathmaker","sylvaniapathmaker_simpL5_qp8_qt9_decompJPEG_1024x1024_Q10",0.61875,81,65,84,68,298
"piano","piano_simpL8_qp11_qt7_decompJPEG_1440x1440_Q90",0.335227272727272,109,90,148,90,437
"piano","piano_simpL9_qp9_qt7_decompJPEG_512x512_Q75",0.36875,109,90,148,90,437
"sylvaniapathmaker","sylvaniapathmaker_simpL1_qp10_qt7_decompJPEG_1024x1024_Q50",0.674418604651163,81,65,84,68,298
"dom_utka","dom_utka_simpL10_qp7_qt6_decompJPEG_1024x1024_Q75",0.654761904761905,45,31,45,27,148
"abel_highpoly_meshexp","abel_highpoly_meshexp_simpL5_qp11_qt6_decompJPEG_1440x1440_Q10",0.55,30,24,20,16,90
"CharlieChaplin","CharlieChaplin_simpL10_qp11_qt6_decompJPEG_712x712_Q90",0.931818181818183,37,32,42,19,130
"to_subs","to_subs_simpL9_qp7_qt6_decompJPEG_2048x2048_Q10",0.912790697674418,15,0,22,0,37
"sylvaniapathmaker","sylvaniapathmaker_simpL10_qp11_qt7_decompJPEG_2048x2048_Q90",0.645348837209302,81,65,84,68,298
"sylvaniapathmaker","sylvaniapathmaker_simpL1_qp8_qt9_decompJPEG_512x512_Q25",0.6,81,65,84,68,298
"CharlieChaplin","CharlieChaplin_simpL9_qp11_qt6_decompJPEG_2048x2048_Q50",0.732558139534882,37,32,42,19,130
"to_subs","to_subs_simpL7_qp8_qt6_decompJPEG_1024x1024_Q10",0.767857142857143,15,0,22,0,37
"piano","piano_simpL4_qp11_qt7_decompJPEG_1024x1024_Q25",0.176136363636362,109,90,148,90,437
"abel_highpoly_meshexp","abel_highpoly_meshexp_simpL7_qp10_qt6_decompJPEG_2048x2048_Q25",0.366279069767443,30,24,20,16,90
"Ailurodus_maculosus","Ailurodus_maculosus_simpL3_qp9_qt10_decompJPEG_712x712_Q50",0.291666666666668,50,47,48,47,192
"CharlieChaplin","CharlieChaplin_simpL10_qp11_qt6_decompJPEG_712x712_Q25",0.892045454545455,37,32,42,19,130
"sylvaniapathmaker","sylvaniapathmaker_simpL4_qp8_qt8_decompJPEG_1024x1024_Q10",0.644444444444445,81,65,84,68,298
"dom_utka","dom_utka_simpL10_qp10_qt6_decompJPEG_2048x2048_Q50",0.563953488372092,45,31,45,27,148
"piano","piano_simpL2_qp11_qt7_decompJPEG_2048x2048_Q75",0.23780487804878,109,90,148,90,437
"Beethoven_bakedUV2","Beethoven_bakedUV2_simpL10_qp9_qt6_decompJPEG_712x712_Q25",0.946428571428573,44,40,44,39,167
"sylvaniapathmaker","sylvaniapathmaker_simpL1_qp8_qt9_decompJPEG_2048x2048_Q90",0.575581395348837,81,65,84,68,298
"sylvaniapathmaker","sylvaniapathmaker_simpL9_qp11_qt7_decompJPEG_1024x1024_Q50",0.676829268292683,81,65,84,68,298
"Jomon_bakedUV","Jomon_bakedUV_simpL4_qp10_qt6_decompJPEG_2048x2048_Q90",0.732558139534882,71,73,86,70,300
"Jomon_bakedUV","Jomon_bakedUV_simpL5_qp8_qt6_decompJPEG_2048x2048_Q90",0.79375,71,73,86,70,300
"abel_highpoly_meshexp","abel_highpoly_meshexp_simpL7_qp9_qt6_decompJPEG_2048x2048_Q25",0.482558139534882,30,24,20,16,90
"abel_highpoly_meshexp","abel_highpoly_meshexp_simpL10_qp7_qt6_decompJPEG_712x712_Q50",0.4375,30,24,20,16,90
"Ailurodus_maculosus","Ailurodus_maculosus_simpL8_qp8_qt8_decompJPEG_512x512_Q50",0.538461538461538,50,47,48,47,192
"Jomon_bakedUV","Jomon_bakedUV_simpL6_qp10_qt10_decompJPEG_2048x2048_Q10",0.261904761904763,71,73,86,70,300
"piano","piano_simpL9_qp9_qt6_decompJPEG_1440x1440_Q50",0.477272727272728,109,90,148,90,437
"Jomon_bakedUV","Jomon_bakedUV_simpL6_qp8_qt10_decompJPEG_512x512_Q90",0.445121951219512,71,73,86,70,300
"sylvaniapathmaker","sylvaniapathmaker_simpL10_qp10_qt8_decompJPEG_2048x2048_Q90",0.589285714285715,81,65,84,68,298
"CharlieChaplin","CharlieChaplin_simpL10_qp10_qt6_decompJPEG_512x512_Q90",0.946428571428573,37,32,42,19,130
"TimeWarner_SA_remote","TimeWarner_SA_remote_simpL1_qp10_qt8_decompJPEG_712x712_Q90",0.65340909090909,53,29,50,28,160
"1970.16_Neck_Amphora_100K","1970.16_Neck_Amphora_100K_simpL10_qp10_qt7_decompJPEG_1024x1024_Q50",0.35,72,77,86,78,313
"1970.16_Neck_Amphora_100K","1970.16_Neck_Amphora_100K_simpL9_qp11_qt7_decompJPEG_1024x1024_Q75",0.291666666666668,72,77,86,78,313
"piano","piano_simpL3_qp9_qt7_decompJPEG_1024x1024_Q90",0.226190476190478,109,90,148,90,437
"sylvaniapathmaker","sylvaniapathmaker_simpL10_qp9_qt9_decompJPEG_2048x2048_Q90",0.573863636363637,81,65,84,68,298
"piano","piano_simpL1_qp9_qt7_decompJPEG_1024x1024_Q90",0.195121951219513,109,90,148,90,437
"to_subs","to_subs_simpL9_qp7_qt6_decompJPEG_1024x1024_Q10",0.953488372093023,15,0,22,0,37
"to_subs","to_subs_simpL9_qp7_qt7_decompJPEG_2048x2048_Q75",0.906976744186047,15,0,22,0,37
"Beethoven_bakedUV2","Beethoven_bakedUV2_simpL9_qp7_qt10_decompJPEG_512x512_Q10",0.94767441860465,44,40,44,39,167
"Beethoven_bakedUV2","Beethoven_bakedUV2_simpL10_qp10_qt6_decompJPEG_2048x2048_Q90",0.948863636363638,44,40,44,39,167
"to_subs","to_subs_simpL3_qp8_qt10_decompJPEG_1440x1440_Q90",0.80232558139535,15,0,22,0,37
"CharlieChaplin","CharlieChaplin_simpL8_qp10_qt6_decompJPEG_1024x1024_Q50",0.63953488372093,37,32,42,19,130
"abel_highpoly_meshexp","abel_highpoly_meshexp_simpL2_qp11_qt6_decompJPEG_512x512_Q90",0.459302325581395,30,24,20,16,90
"Beethoven_bakedUV2","Beethoven_bakedUV2_simpL10_qp9_qt6_decompJPEG_512x512_Q10",0.932926829268293,44,40,44,39,167
"Ailurodus_maculosus","Ailurodus_maculosus_simpL10_qp11_qt10_decompJPEG_1440x1440_Q25",0.397727272727272,50,47,48,47,192
"sylvaniapathmaker","sylvaniapathmaker_simpL9_qp9_qt8_decompJPEG_2048x2048_Q90",0.52439024390244,81,65,84,68,298
"Jomon_bakedUV","Jomon_bakedUV_simpL8_qp8_qt9_decompJPEG_512x512_Q75",0.52840909090909,71,73,86,70,300
"Jomon_bakedUV","Jomon_bakedUV_simpL8_qp8_qt8_decompJPEG_2048x2048_Q25",0.453488372093023,71,73,86,70,300
"1970.16_Neck_Amphora_100K","1970.16_Neck_Amphora_100K_simpL10_qp9_qt6_decompJPEG_1440x1440_Q75",0.397727272727272,72,77,86,78,313
"Beethoven_bakedUV2","Beethoven_bakedUV2_simpL2_qp10_qt7_decompJPEG_512x512_Q90",0.430232558139535,44,40,44,39,167
"sylvaniapathmaker","sylvaniapathmaker_simpL3_qp9_qt8_decompJPEG_712x712_Q25",0.517045454545455,81,65,84,68,298
"TimeWarner_SA_remote","TimeWarner_SA_remote_simpL2_qp9_qt6_decompJPEG_2048x2048_Q75",0.871951219512195,53,29,50,28,160
"to_subs","to_subs_simpL9_qp8_qt9_decompJPEG_1024x1024_Q25",0.625,15,0,22,0,37
"Ailurodus_maculosus","Ailurodus_maculosus_simpL10_qp11_qt6_decompJPEG_712x712_Q25",0.539772727272728,50,47,48,47,192
"CharlieChaplin","CharlieChaplin_simpL8_qp8_qt10_decompJPEG_2048x2048_Q75",0.738372093023255,37,32,42,19,130
"1970.16_Neck_Amphora_100K","1970.16_Neck_Amphora_100K_simpL10_qp8_qt7_decompJPEG_1024x1024_Q25",0.327380952380953,72,77,86,78,313
"abel_highpoly_meshexp","abel_highpoly_meshexp_simpL9_qp10_qt6_decompJPEG_1440x1440_Q50",0.445121951219512,30,24,20,16,90
"TimeWarner_SA_remote","TimeWarner_SA_remote_simpL8_qp9_qt6_decompJPEG_2048x2048_Q25",0.914772727272728,53,29,50,28,160
"Jomon_bakedUV","Jomon_bakedUV_simpL10_qp7_qt10_decompJPEG_2048x2048_Q75",0.943181818181817,71,73,86,70,300
"sylvaniapathmaker","sylvaniapathmaker_simpL6_qp7_qt10_decompJPEG_1440x1440_Q50",0.76829268292683,81,65,84,68,298
"abel_highpoly_meshexp","abel_highpoly_meshexp_simpL3_qp8_qt10_decompJPEG_1440x1440_Q75",0.625,30,24,20,16,90
"piano","piano_simpL6_qp11_qt7_decompJPEG_2048x2048_Q50",0.2375,109,90,148,90,437
"sylvaniapathmaker","sylvaniapathmaker_simpL8_qp7_qt9_decompJPEG_512x512_Q25",0.761363636363638,81,65,84,68,298
"CharlieChaplin","CharlieChaplin_simpL9_qp8_qt7_decompJPEG_1440x1440_Q50",0.761627906976745,37,32,42,19,130
"to_subs","to_subs_simpL3_qp8_qt10_decompJPEG_1024x1024_Q50",0.743589743589743,15,0,22,0,37
"1970.16_Neck_Amphora_100K","1970.16_Neck_Amphora_100K_simpL4_qp10_qt9_decompJPEG_512x512_Q50",0.220238095238095,72,77,86,78,313
"dom_utka","dom_utka_simpL9_qp7_qt8_decompJPEG_512x512_Q90",0.63953488372093,45,31,45,27,148
"TimeWarner_SA_remote","TimeWarner_SA_remote_simpL7_qp11_qt6_decompJPEG_512x512_Q50",0.83974358974359,53,29,50,28,160
"dom_utka","dom_utka_simpL10_qp8_qt8_decompJPEG_1024x1024_Q50",0.4875,45,31,45,27,148
"Jomon_bakedUV","Jomon_bakedUV_simpL9_qp10_qt6_decompJPEG_2048x2048_Q50",0.788461538461537,71,73,86,70,300
"TimeWarner_SA_remote","TimeWarner_SA_remote_simpL3_qp10_qt6_decompJPEG_1440x1440_Q10",0.88125,53,29,50,28,160
"Beethoven_bakedUV2","Beethoven_bakedUV2_simpL7_qp11_qt6_decompJPEG_2048x2048_Q90",0.704545454545455,44,40,44,39,167
"abel_highpoly_meshexp","abel_highpoly_meshexp_simpL7_qp8_qt8_decompJPEG_1024x1024_Q90",0.572222222222223,30,24,20,16,90
"Ailurodus_maculosus","Ailurodus_maculosus_simpL10_qp9_qt6_decompJPEG_1440x1440_Q10",0.55952380952381,50,47,48,47,192
"dom_utka","dom_utka_simpL10_qp7_qt6_decompJPEG_1440x1440_Q90",0.619318181818183,45,31,45,27,148
"TimeWarner_SA_remote","TimeWarner_SA_remote_simpL6_qp9_qt9_decompJPEG_1440x1440_Q75",0.598837209302325,53,29,50,28,160
"abel_highpoly_meshexp","abel_highpoly_meshexp_simpL3_qp8_qt9_decompJPEG_1440x1440_Q75",0.625,30,24,20,16,90
"to_subs","to_subs_simpL1_qp7_qt7_decompJPEG_1024x1024_Q75",0.94186046511628,15,0,22,0,37
"Ailurodus_maculosus","Ailurodus_maculosus_simpL9_qp8_qt9_decompJPEG_1440x1440_Q10",0.551136363636363,50,47,48,47,192
"dom_utka","dom_utka_simpL10_qp11_qt6_decompJPEG_2048x2048_Q25",0.53125,45,31,45,27,148
"piano","piano_simpL5_qp10_qt7_decompJPEG_1024x1024_Q25",0.164772727272728,109,90,148,90,437
"CharlieChaplin","CharlieChaplin_simpL10_qp7_qt6_decompJPEG_712x712_Q25",0.97093023255814,37,32,42,19,130
"sylvaniapathmaker","sylvaniapathmaker_simpL1_qp8_qt8_decompJPEG_712x712_Q10",0.673076923076922,81,65,84,68,298
"abel_highpoly_meshexp","abel_highpoly_meshexp_simpL4_qp9_qt6_decompJPEG_712x712_Q50",0.47159090909091,30,24,20,16,90
"dom_utka","dom_utka_simpL10_qp7_qt6_decompJPEG_1440x1440_Q25",0.64375,45,31,45,27,148
"sylvaniapathmaker","sylvaniapathmaker_simpL1_qp8_qt10_decompJPEG_1024x1024_Q10",0.636904761904763,81,65,84,68,298
"to_subs","to_subs_simpL9_qp8_qt10_decompJPEG_512x512_Q10",0.71590909090909,15,0,22,0,37
"Ailurodus_maculosus","Ailurodus_maculosus_simpL10_qp10_qt10_decompJPEG_2048x2048_Q90",0.36111111111111,50,47,48,47,192
"to_subs","to_subs_simpL10_qp7_qt10_decompJPEG_2048x2048_Q10",0.988095238095237,15,0,22,0,37
"CharlieChaplin","CharlieChaplin_simpL9_qp9_qt7_decompJPEG_712x712_Q90",0.656976744186047,37,32,42,19,130
"sylvaniapathmaker","sylvaniapathmaker_simpL6_qp11_qt7_decompJPEG_512x512_Q25",0.630681818181817,81,65,84,68,298
"piano","piano_simpL9_qp9_qt6_decompJPEG_2048x2048_Q75",0.5,109,90,148,90,437
"sylvaniapathmaker","sylvaniapathmaker_simpL4_qp9_qt7_decompJPEG_1440x1440_Q10",0.790697674418605,81,65,84,68,298
"piano","piano_simpL8_qp11_qt7_decompJPEG_1440x1440_Q50",0.28048780487805,109,90,148,90,437
"TimeWarner_SA_remote","TimeWarner_SA_remote_simpL6_qp11_qt6_decompJPEG_712x712_Q50",0.837209302325582,53,29,50,28,160
"1970.16_Neck_Amphora_100K","1970.16_Neck_Amphora_100K_simpL9_qp11_qt7_decompJPEG_1024x1024_Q90",0.352272727272728,72,77,86,78,313
"CharlieChaplin","CharlieChaplin_simpL4_qp11_qt6_decompJPEG_2048x2048_Q50",0.642045454545455,37,32,42,19,130
"TimeWarner_SA_remote","TimeWarner_SA_remote_simpL2_qp9_qt6_decompJPEG_2048x2048_Q90",0.845238095238095,53,29,50,28,160
"to_subs","to_subs_simpL9_qp8_qt6_decompJPEG_712x712_Q25",0.74404761904762,15,0,22,0,37
"abel_highpoly_meshexp","abel_highpoly_meshexp_simpL1_qp8_qt9_decompJPEG_712x712_Q75",0.647727272727272,30,24,20,16,90
"Ailurodus_maculosus","Ailurodus_maculosus_simpL10_qp11_qt6_decompJPEG_1024x1024_Q25",0.56875,50,47,48,47,192
"Ailurodus_maculosus","Ailurodus_maculosus_simpL10_qp11_qt6_decompJPEG_1440x1440_Q25",0.517441860465118,50,47,48,47,192
"Ailurodus_maculosus","Ailurodus_maculosus_simpL4_qp11_qt10_decompJPEG_712x712_Q75",0.175,50,47,48,47,192
"Beethoven_bakedUV2","Beethoven_bakedUV2_simpL9_qp8_qt7_decompJPEG_712x712_Q90",0.71875,44,40,44,39,167
"TimeWarner_SA_remote","TimeWarner_SA_remote_simpL6_qp10_qt6_decompJPEG_712x712_Q90",0.833333333333332,53,29,50,28,160
"TimeWarner_SA_remote","TimeWarner_SA_remote_simpL9_qp11_qt6_decompJPEG_1440x1440_Q50",0.83139534883721,53,29,50,28,160
"Jomon_bakedUV","Jomon_bakedUV_simpL10_qp9_qt10_decompJPEG_1440x1440_Q90",0.88095238095238,71,73,86,70,300
"dom_utka","dom_utka_simpL5_qp8_qt8_decompJPEG_1024x1024_Q10",0.540697674418605,45,31,45,27,148
"CharlieChaplin","CharlieChaplin_simpL7_qp8_qt10_decompJPEG_1024x1024_Q90",0.77906976744186,37,32,42,19,130
"Ailurodus_maculosus","Ailurodus_maculosus_simpL4_qp11_qt6_decompJPEG_512x512_Q25",0.627777777777778,50,47,48,47,192
"Jomon_bakedUV","Jomon_bakedUV_simpL7_qp8_qt9_decompJPEG_2048x2048_Q10",0.568181818181817,71,73,86,70,300
"1970.16_Neck_Amphora_100K","1970.16_Neck_Amphora_100K_simpL10_qp10_qt10_decompJPEG_2048x2048_Q90",0.296511627906977,72,77,86,78,313
"dom_utka","dom_utka_simpL10_qp8_qt8_decompJPEG_2048x2048_Q25",0.55232558139535,45,31,45,27,148
